entry_time,exit_time,position,entry_price,exit_price,size,pnl,exit_reason,bars_held,market_conditions,daily_pnl,trades_today,balance
2025-06-03 19:45:00,2025-06-03 20:15:00,BUY,3348.55,3353.27,0.01,47.2,take_profit,3,"{'rsi_14': 53.278239841407064, 'adx': 11.498533705169242, 'trend_strength': 0.11498533705169242, 'volatility_ratio': 0.0014112598380760452, 'bb_width': 0.004162687401954372, 'prediction_confidence': 0.6, 'prediction_stability': 0.6, 'market_score': 5, 'raw_prediction': 3.8779500658354214e-08, 'scaled_prediction': 1.9389750329177107e-05}",94.4,1,77.2
2025-06-03 21:30:00,2025-06-03 22:00:00,BUY,3351.54,3354.37,0.01,28.3,take_profit,3,"{'rsi_14': 53.278239841407064, 'adx': 11.498533705169242, 'trend_strength': 0.11498533705169242, 'volatility_ratio': 0.0014112598380760452, 'bb_width': 0.004162687401954372, 'prediction_confidence': 0.6, 'prediction_stability': 0.6, 'market_score': 5, 'raw_prediction': 5.3412877674983516e-08, 'scaled_prediction': 2.6706438837491758e-05}",56.6,2,105.5
2025-06-03 22:15:00,2025-06-04 01:00:00,BUY,3353.21,3356.32,0.01,31.1,take_profit,13,"{'rsi_14': 53.278239841407064, 'adx': 11.498533705169242, 'trend_strength': 0.11498533705169242, 'volatility_ratio': 0.0014112598380760452, 'bb_width': 0.004162687401954372, 'prediction_confidence': 0.6, 'prediction_stability': 0.6, 'market_score': 5, 'raw_prediction': 1.7500678947200268e-07, 'scaled_prediction': 8.750339473600134e-05}",62.2,3,136.6
2025-06-04 01:15:00,2025-06-04 02:00:00,BUY,3357.53,3360.21,0.01,26.8,take_profit,5,"{'rsi_14': 53.278239841407064, 'adx': 11.498533705169242, 'trend_strength': 0.11498533705169242, 'volatility_ratio': 0.0014112598380760452, 'bb_width': 0.004162687401954372, 'prediction_confidence': 0.6, 'prediction_stability': 0.6, 'market_score': 5, 'raw_prediction': 1.1575485416579568e-07, 'scaled_prediction': 5.7877427082897844e-05}",53.6,4,163.4
2025-06-04 02:15:00,2025-06-04 03:00:00,BUY,3358.46,3354.03,0.01,-19.608,daily_loss_limit,5,"{'rsi_14': 53.278239841407064, 'adx': 11.498533705169242, 'trend_strength': 0.11498533705169242, 'volatility_ratio': 0.0014112598380760452, 'bb_width': 0.004162687401954372, 'prediction_confidence': 0.6, 'prediction_stability': 0.6, 'market_score': 5, 'raw_prediction': 2.0631680670386507e-07, 'scaled_prediction': 0.00010315840335193253}",-63.908,5,143.792
2025-06-04 03:00:00,2025-06-04 03:15:00,BUY,3354.03,3357.25,0.01,32.2,take_profit,1,"{'rsi_14': 53.278239841407064, 'adx': 11.498533705169242, 'trend_strength': 0.11498533705169242, 'volatility_ratio': 0.0014112598380760452, 'bb_width': 0.004162687401954372, 'prediction_confidence': 0.6, 'prediction_stability': 0.6, 'market_score': 5, 'raw_prediction': 2.6391798743765435e-07, 'scaled_prediction': 0.00013195899371882717}",64.4,6,175.99200000000002
2025-06-04 04:00:00,2025-06-04 04:15:00,BUY,3357.9,3363.47,0.01,55.7,take_profit,1,"{'rsi_14': 53.278239841407064, 'adx': 11.498533705169242, 'trend_strength': 0.11498533705169242, 'volatility_ratio': 0.0014112598380760452, 'bb_width': 0.004162687401954372, 'prediction_confidence': 0.6, 'prediction_stability': 0.6, 'market_score': 5, 'raw_prediction': 3.786564033699673e-08, 'scaled_prediction': 1.8932820168498364e-05}",111.4,7,231.692
2025-06-04 04:30:00,2025-06-04 04:45:00,BUY,3367.08,3370.8,0.01,37.2,take_profit,1,"{'rsi_14': 53.278239841407064, 'adx': 11.498533705169242, 'trend_strength': 0.11498533705169242, 'volatility_ratio': 0.0014112598380760452, 'bb_width': 0.004162687401954372, 'prediction_confidence': 0.6, 'prediction_stability': 0.6, 'market_score': 5, 'raw_prediction': 6.276615763058134e-08, 'scaled_prediction': 3.1383078815290666e-05}",74.4,8,268.892
2025-06-04 05:00:00,2025-06-04 05:15:00,BUY,3372.16,3368.75,0.01,-32.26704,daily_loss_limit,1,"{'rsi_14': 53.278239841407064, 'adx': 11.498533705169242, 'trend_strength': 0.11498533705169242, 'volatility_ratio': 0.0014112598380760452, 'bb_width': 0.004162687401954372, 'prediction_confidence': 0.6, 'prediction_stability': 0.6, 'market_score': 5, 'raw_prediction': 1.103055108884011e-07, 'scaled_prediction': 5.515275544420055e-05}",-66.36704,9,236.62496
2025-06-04 05:15:00,2025-06-04 05:30:00,BUY,3368.75,3366.34,0.01,-24.1,stop_loss,1,"{'rsi_14': 53.278239841407064, 'adx': 11.498533705169242, 'trend_strength': 0.11498533705169242, 'volatility_ratio': 0.0014112598380760452, 'bb_width': 0.004162687401954372, 'prediction_confidence': 0.6, 'prediction_stability': 0.6, 'market_score': 5, 'raw_prediction': 3.435385598890062e-08, 'scaled_prediction': 1.717692799445031e-05}",-48.2,10,212.52496
2025-06-04 05:45:00,2025-06-04 06:00:00,BUY,3365.6,3364.19,0.01,-14.1,stop_loss,1,"{'rsi_14': 53.278239841407064, 'adx': 11.498533705169242, 'trend_strength': 0.11498533705169242, 'volatility_ratio': 0.0014112598380760452, 'bb_width': 0.004162687401954372, 'prediction_confidence': 0.6, 'prediction_stability': 0.6, 'market_score': 5, 'raw_prediction': 7.268640329903941e-07, 'scaled_prediction': 0.00036343201649519704}",-28.2,11,198.42496
2025-06-04 06:15:00,2025-06-04 06:30:00,BUY,3365.83,3360.44,0.01,-23.8109952,daily_loss_limit,1,"{'rsi_14': 53.278239841407064, 'adx': 11.498533705169242, 'trend_strength': 0.11498533705169242, 'volatility_ratio': 0.0014112598380760452, 'bb_width': 0.004162687401954372, 'prediction_confidence': 0.6, 'prediction_stability': 0.6, 'market_score': 5, 'raw_prediction': 6.295877974706505e-07, 'scaled_prediction': 0.00031479389873532526}",-77.7109952,12,174.6139648
2025-06-04 06:30:00,2025-06-04 06:45:00,BUY,3360.44,3359.29,0.01,-11.5,stop_loss,1,"{'rsi_14': 53.278239841407064, 'adx': 11.498533705169242, 'trend_strength': 0.11498533705169242, 'volatility_ratio': 0.0014112598380760452, 'bb_width': 0.004162687401954372, 'prediction_confidence': 0.6, 'prediction_stability': 0.6, 'market_score': 5, 'raw_prediction': 4.0578001069704047e-07, 'scaled_prediction': 0.00020289000534852024}",-23.0,13,163.1139648
2025-06-04 07:00:00,2025-06-04 07:30:00,BUY,3358.91,3354.98,0.01,-19.573675775999998,daily_loss_limit,3,"{'rsi_14': 53.278239841407064, 'adx': 11.498533705169242, 'trend_strength': 0.11498533705169242, 'volatility_ratio': 0.0014112598380760452, 'bb_width': 0.004162687401954372, 'prediction_confidence': 0.6, 'prediction_stability': 0.6, 'market_score': 5, 'raw_prediction': 2.730423585014521e-07, 'scaled_prediction': 0.00013652117925072607}",-58.873675776,14,143.540289024
2025-06-04 07:30:00,2025-06-04 08:15:00,BUY,3354.98,3351.69,0.01,-17.22483468288,daily_loss_limit,5,"{'rsi_14': 53.278239841407064, 'adx': 11.498533705169242, 'trend_strength': 0.11498533705169242, 'volatility_ratio': 0.0014112598380760452, 'bb_width': 0.004162687401954372, 'prediction_confidence': 0.6, 'prediction_stability': 0.6, 'market_score': 5, 'raw_prediction': 1.7781004141650137e-07, 'scaled_prediction': 8.890502070825068e-05}",-50.12483468288,15,126.31545434112
2025-06-04 08:15:00,2025-06-04 09:15:00,BUY,3351.69,3355.09,0.01,34.0,take_profit,7,"{'rsi_14': 53.278239841407064, 'adx': 11.498533705169242, 'trend_strength': 0.11498533705169242, 'volatility_ratio': 0.0014112598380760452, 'bb_width': 0.004162687401954372, 'prediction_confidence': 0.6, 'prediction_stability': 0.6, 'market_score': 5, 'raw_prediction': 2.0632847740291947e-07, 'scaled_prediction': 0.00010316423870145974}",68.0,16,160.31545434112002
2025-06-04 09:30:00,2025-06-04 10:00:00,BUY,3356.1,3359.89,0.01,37.9,take_profit,3,"{'rsi_14': 53.278239841407064, 'adx': 11.498533705169242, 'trend_strength': 0.11498533705169242, 'volatility_ratio': 0.0014112598380760452, 'bb_width': 0.004162687401954372, 'prediction_confidence': 0.6, 'prediction_stability': 0.6, 'market_score': 5, 'raw_prediction': 3.277121285816415e-07, 'scaled_prediction': 0.00016385606429082075}",75.8,17,198.21545434112002
2025-06-04 10:15:00,2025-06-04 10:45:00,BUY,3361.19,3354.66,0.01,-23.7858545209344,daily_loss_limit,3,"{'rsi_14': 53.278239841407064, 'adx': 11.498533705169242, 'trend_strength': 0.11498533705169242, 'volatility_ratio': 0.0014112598380760452, 'bb_width': 0.004162687401954372, 'prediction_confidence': 0.6, 'prediction_stability': 0.6, 'market_score': 5, 'raw_prediction': 3.3854166399083226e-07, 'scaled_prediction': 0.00016927083199541612}",-89.08585452093439,18,174.42959982018562
2025-06-04 10:45:00,2025-06-04 11:30:00,BUY,3354.66,3359.91,0.01,52.5,take_profit,5,"{'rsi_14': 53.278239841407064, 'adx': 11.498533705169242, 'trend_strength': 0.11498533705169242, 'volatility_ratio': 0.0014112598380760452, 'bb_width': 0.004162687401954372, 'prediction_confidence': 0.6, 'prediction_stability': 0.6, 'market_score': 5, 'raw_prediction': 2.1888782792551362e-07, 'scaled_prediction': 0.00010944391396275681}",105.0,19,226.92959982018562
2025-06-04 11:45:00,2025-06-04 12:00:00,BUY,3362.89,3361.41,0.01,-14.8,stop_loss,1,"{'rsi_14': 53.278239841407064, 'adx': 11.498533705169242, 'trend_strength': 0.11498533705169242, 'volatility_ratio': 0.0014112598380760452, 'bb_width': 0.004162687401954372, 'prediction_confidence': 0.6, 'prediction_stability': 0.6, 'market_score': 5, 'raw_prediction': 2.8631751769898877e-07, 'scaled_prediction': 0.0001431587588494944}",-29.6,20,212.1295998201856
2025-06-04 12:15:00,2025-06-04 12:30:00,BUY,3364.23,3361.56,0.01,-25.45555197842227,daily_loss_limit,1,"{'rsi_14': 53.278239841407064, 'adx': 11.498533705169242, 'trend_strength': 0.11498533705169242, 'volatility_ratio': 0.0014112598380760452, 'bb_width': 0.004162687401954372, 'prediction_confidence': 0.6, 'prediction_stability': 0.6, 'market_score': 5, 'raw_prediction': 4.5293610301375293e-07, 'scaled_prediction': 0.00022646805150687647}",-52.15555197842227,21,186.67404784176333
2025-06-04 12:30:00,2025-06-04 13:00:00,BUY,3361.56,3359.83,0.01,-17.3,stop_loss,3,"{'rsi_14': 53.278239841407064, 'adx': 11.498533705169242, 'trend_strength': 0.11498533705169242, 'volatility_ratio': 0.0014112598380760452, 'bb_width': 0.004162687401954372, 'prediction_confidence': 0.6, 'prediction_stability': 0.6, 'market_score': 5, 'raw_prediction': 2.2230426829896867e-07, 'scaled_prediction': 0.00011115213414948434}",-34.6,22,169.3740478417633
2025-06-04 13:15:00,2025-06-04 13:30:00,BUY,3358.44,3354.56,0.01,-20.324885741011595,daily_loss_limit,1,"{'rsi_14': 53.278239841407064, 'adx': 11.498533705169242, 'trend_strength': 0.11498533705169242, 'volatility_ratio': 0.0014112598380760452, 'bb_width': 0.004162687401954372, 'prediction_confidence': 0.6, 'prediction_stability': 0.6, 'market_score': 5, 'raw_prediction': 3.5756459676621523e-07, 'scaled_prediction': 0.0001787822983831076}",-59.124885741011596,23,149.04916210075172
2025-06-04 13:30:00,2025-06-04 13:45:00,BUY,3354.56,3350.95,0.01,-17.885899452090204,daily_loss_limit,1,"{'rsi_14': 53.278239841407064, 'adx': 11.498533705169242, 'trend_strength': 0.11498533705169242, 'volatility_ratio': 0.0014112598380760452, 'bb_width': 0.004162687401954372, 'prediction_confidence': 0.6, 'prediction_stability': 0.6, 'market_score': 5, 'raw_prediction': 3.3922737933145407e-07, 'scaled_prediction': 0.00016961368966572702}",-53.98589945209021,24,131.16326264866152
2025-06-04 13:45:00,2025-06-04 14:15:00,BUY,3350.95,3346.52,0.01,-15.739591517839381,daily_loss_limit,3,"{'rsi_14': 53.278239841407064, 'adx': 11.498533705169242, 'trend_strength': 0.11498533705169242, 'volatility_ratio': 0.0014112598380760452, 'bb_width': 0.004162687401954372, 'prediction_confidence': 0.6, 'prediction_stability': 0.6, 'market_score': 5, 'raw_prediction': 3.2589325574336947e-07, 'scaled_prediction': 0.00016294662787168473}",-60.039591517839376,25,115.42367113082213
2025-06-04 14:15:00,2025-06-04 14:30:00,BUY,3346.52,3349.35,0.01,28.3,take_profit,1,"{'rsi_14': 53.278239841407064, 'adx': 11.498533705169242, 'trend_strength': 0.11498533705169242, 'volatility_ratio': 0.0014112598380760452, 'bb_width': 0.004162687401954372, 'prediction_confidence': 0.6, 'prediction_stability': 0.6, 'market_score': 5, 'raw_prediction': 3.461503947663702e-07, 'scaled_prediction': 0.00017307519738318512}",56.6,26,143.72367113082214
2025-06-04 14:45:00,2025-06-04 15:15:00,BUY,3346.62,3349.47,0.01,28.5,take_profit,3,"{'rsi_14': 53.278239841407064, 'adx': 11.498533705169242, 'trend_strength': 0.11498533705169242, 'volatility_ratio': 0.0014112598380760452, 'bb_width': 0.004162687401954372, 'prediction_confidence': 0.6, 'prediction_stability': 0.6, 'market_score': 5, 'raw_prediction': 2.956111275145297e-07, 'scaled_prediction': 0.00014780556375726484}",57.0,27,172.22367113082214
2025-06-04 15:30:00,2025-06-04 15:45:00,BUY,3355.67,3358.65,0.01,29.8,take_profit,1,"{'rsi_14': 53.278239841407064, 'adx': 11.498533705169242, 'trend_strength': 0.11498533705169242, 'volatility_ratio': 0.0014112598380760452, 'bb_width': 0.004162687401954372, 'prediction_confidence': 0.6, 'prediction_stability': 0.6, 'market_score': 5, 'raw_prediction': 1.4370858832334164e-07, 'scaled_prediction': 7.185429416167082e-05}",59.6,28,202.02367113082215
2025-06-04 16:00:00,2025-06-04 16:30:00,BUY,3358.63,3353.02,0.01,-24.242840535698658,daily_loss_limit,3,"{'rsi_14': 53.278239841407064, 'adx': 11.498533705169242, 'trend_strength': 0.11498533705169242, 'volatility_ratio': 0.0014112598380760452, 'bb_width': 0.004162687401954372, 'prediction_confidence': 0.6, 'prediction_stability': 0.6, 'market_score': 5, 'raw_prediction': 9.999885512907494e-08, 'scaled_prediction': 4.999942756453747e-05}",-80.34284053569866,29,177.7808305951235
2025-06-04 16:45:00,2025-06-04 17:00:00,BUY,3352.79,3366.52,0.01,137.3,take_profit,1,"{'rsi_14': 53.278239841407064, 'adx': 11.498533705169242, 'trend_strength': 0.11498533705169242, 'volatility_ratio': 0.0014112598380760452, 'bb_width': 0.004162687401954372, 'prediction_confidence': 0.6, 'prediction_stability': 0.6, 'market_score': 5, 'raw_prediction': 8.70221701190619e-08, 'scaled_prediction': 4.351108505953095e-05}",274.6,30,315.08083059512353
2025-06-04 17:15:00,2025-06-04 17:30:00,BUY,3369.45,3382.52,0.01,130.7,take_profit,1,"{'rsi_14': 53.278239841407064, 'adx': 11.498533705169242, 'trend_strength': 0.11498533705169242, 'volatility_ratio': 0.0014112598380760452, 'bb_width': 0.004162687401954372, 'prediction_confidence': 0.6, 'prediction_stability': 0.6, 'market_score': 5, 'raw_prediction': 3.572780403532864e-08, 'scaled_prediction': 1.786390201766432e-05}",261.4,31,445.7808305951235
2025-06-04 17:45:00,2025-06-04 18:00:00,BUY,3377.3,3372.74,0.01,-45.6,stop_loss,1,"{'rsi_14': 53.278239841407064, 'adx': 11.498533705169242, 'trend_strength': 0.11498533705169242, 'volatility_ratio': 0.0014112598380760452, 'bb_width': 0.004162687401954372, 'prediction_confidence': 0.6, 'prediction_stability': 0.6, 'market_score': 5, 'raw_prediction': 2.0387124102579452e-07, 'scaled_prediction': 0.00010193562051289726}",-91.2,32,400.1808305951235
2025-06-04 19:30:00,2025-06-04 20:30:00,BUY,3373.1,3378.7,0.01,56.0,take_profit,7,"{'rsi_14': 53.278239841407064, 'adx': 11.498533705169242, 'trend_strength': 0.11498533705169242, 'volatility_ratio': 0.0014112598380760452, 'bb_width': 0.004162687401954372, 'prediction_confidence': 0.6, 'prediction_stability': 0.6, 'market_score': 5, 'raw_prediction': 1.242798607803033e-07, 'scaled_prediction': 6.213993039015165e-05}",112.0,33,456.1808305951235
2025-06-04 21:30:00,2025-06-04 22:00:00,BUY,3377.28,3374.32,0.01,-29.6,stop_loss,3,"{'rsi_14': 53.278239841407064, 'adx': 11.498533705169242, 'trend_strength': 0.11498533705169242, 'volatility_ratio': 0.0014112598380760452, 'bb_width': 0.004162687401954372, 'prediction_confidence': 0.6, 'prediction_stability': 0.6, 'market_score': 5, 'raw_prediction': 3.675882175447578e-08, 'scaled_prediction': 1.837941087723789e-05}",-59.2,34,426.5808305951235
2025-06-04 22:15:00,2025-06-04 22:30:00,BUY,3373.32,3372.15,0.01,-11.7,stop_loss,1,"{'rsi_14': 53.278239841407064, 'adx': 11.498533705169242, 'trend_strength': 0.11498533705169242, 'volatility_ratio': 0.0014112598380760452, 'bb_width': 0.004162687401954372, 'prediction_confidence': 0.6, 'prediction_stability': 0.6, 'market_score': 5, 'raw_prediction': 4.374659620689597e-07, 'scaled_prediction': 0.00021873298103447983}",-23.4,35,414.8808305951235
2025-06-04 22:45:00,2025-06-05 02:15:00,BUY,3373.38,3378.57,0.01,51.9,take_profit,19,"{'rsi_14': 53.278239841407064, 'adx': 11.498533705169242, 'trend_strength': 0.11498533705169242, 'volatility_ratio': 0.0014112598380760452, 'bb_width': 0.004162687401954372, 'prediction_confidence': 0.6, 'prediction_stability': 0.6, 'market_score': 5, 'raw_prediction': 6.214429157675192e-07, 'scaled_prediction': 0.00031072145788375963}",103.8,36,466.78083059512346
2025-06-05 02:30:00,2025-06-05 02:45:00,BUY,3375.41,3378.02,0.01,26.1,take_profit,1,"{'rsi_14': 53.278239841407064, 'adx': 11.498533705169242, 'trend_strength': 0.11498533705169242, 'volatility_ratio': 0.0014112598380760452, 'bb_width': 0.004162687401954372, 'prediction_confidence': 0.6, 'prediction_stability': 0.6, 'market_score': 5, 'raw_prediction': 3.6057367118712073e-07, 'scaled_prediction': 0.00018028683559356037}",52.2,37,492.8808305951235
2025-06-05 03:00:00,2025-06-05 03:15:00,BUY,3378.04,3380.91,0.01,28.7,take_profit,1,"{'rsi_14': 53.278239841407064, 'adx': 11.498533705169242, 'trend_strength': 0.11498533705169242, 'volatility_ratio': 0.0014112598380760452, 'bb_width': 0.004162687401954372, 'prediction_confidence': 0.6, 'prediction_stability': 0.6, 'market_score': 5, 'raw_prediction': 2.381623198179588e-07, 'scaled_prediction': 0.0001190811599089794}",57.4,38,521.5808305951235
2025-06-05 03:30:00,2025-06-05 03:45:00,BUY,3375.95,3380.04,0.01,40.9,take_profit,1,"{'rsi_14': 53.278239841407064, 'adx': 11.498533705169242, 'trend_strength': 0.11498533705169242, 'volatility_ratio': 0.0014112598380760452, 'bb_width': 0.004162687401954372, 'prediction_confidence': 0.6, 'prediction_stability': 0.6, 'market_score': 5, 'raw_prediction': 1.4653407557786487e-07, 'scaled_prediction': 7.326703778893244e-05}",81.8,39,562.4808305951235
2025-06-05 04:00:00,2025-06-05 04:15:00,BUY,3379.92,3377.52,0.01,-24.0,stop_loss,1,"{'rsi_14': 53.278239841407064, 'adx': 11.498533705169242, 'trend_strength': 0.11498533705169242, 'volatility_ratio': 0.0014112598380760452, 'bb_width': 0.004162687401954372, 'prediction_confidence': 0.6, 'prediction_stability': 0.6, 'market_score': 5, 'raw_prediction': 1.8214508585299816e-07, 'scaled_prediction': 9.107254292649909e-05}",-48.0,40,538.4808305951235
2025-06-05 04:30:00,2025-06-05 05:00:00,BUY,3373.58,3370.51,0.01,-30.7,stop_loss,3,"{'rsi_14': 53.278239841407064, 'adx': 11.498533705169242, 'trend_strength': 0.11498533705169242, 'volatility_ratio': 0.0014112598380760452, 'bb_width': 0.004162687401954372, 'prediction_confidence': 0.6, 'prediction_stability': 0.6, 'market_score': 5, 'raw_prediction': 6.068632938270153e-07, 'scaled_prediction': 0.0003034316469135077}",-61.4,41,507.7808305951235
2025-06-05 05:15:00,2025-06-05 06:30:00,BUY,3371.49,3374.53,0.01,30.4,take_profit,9,"{'rsi_14': 53.278239841407064, 'adx': 11.498533705169242, 'trend_strength': 0.11498533705169242, 'volatility_ratio': 0.0014112598380760452, 'bb_width': 0.004162687401954372, 'prediction_confidence': 0.6, 'prediction_stability': 0.6, 'market_score': 5, 'raw_prediction': 5.299326148606983e-07, 'scaled_prediction': 0.00026496630743034913}",60.8,42,538.1808305951236
2025-06-05 06:45:00,2025-06-05 07:15:00,BUY,3369.82,3367.55,0.01,-22.7,stop_loss,3,"{'rsi_14': 53.278239841407064, 'adx': 11.498533705169242, 'trend_strength': 0.11498533705169242, 'volatility_ratio': 0.0014112598380760452, 'bb_width': 0.004162687401954372, 'prediction_confidence': 0.6, 'prediction_stability': 0.6, 'market_score': 5, 'raw_prediction': 1.1747975817154858e-07, 'scaled_prediction': 5.873987908577429e-05}",-45.4,43,515.4808305951235
2025-06-05 07:30:00,2025-06-05 08:15:00,BUY,3367.82,3365.89,0.01,-19.3,stop_loss,5,"{'rsi_14': 53.278239841407064, 'adx': 11.498533705169242, 'trend_strength': 0.11498533705169242, 'volatility_ratio': 0.0014112598380760452, 'bb_width': 0.004162687401954372, 'prediction_confidence': 0.6, 'prediction_stability': 0.6, 'market_score': 5, 'raw_prediction': 5.585156031322539e-07, 'scaled_prediction': 0.00027925780156612694}",-38.6,44,496.1808305951235
2025-06-05 08:30:00,2025-06-05 08:45:00,BUY,3365.68,3364.45,0.01,-12.3,stop_loss,1,"{'rsi_14': 53.278239841407064, 'adx': 11.498533705169242, 'trend_strength': 0.11498533705169242, 'volatility_ratio': 0.0014112598380760452, 'bb_width': 0.004162687401954372, 'prediction_confidence': 0.6, 'prediction_stability': 0.6, 'market_score': 5, 'raw_prediction': 4.4260101277184874e-07, 'scaled_prediction': 0.00022130050638592436}",-24.6,45,483.8808305951235
2025-06-05 09:00:00,2025-06-05 09:30:00,BUY,3367.71,3365.12,0.01,-25.9,stop_loss,3,"{'rsi_14': 53.278239841407064, 'adx': 11.498533705169242, 'trend_strength': 0.11498533705169242, 'volatility_ratio': 0.0014112598380760452, 'bb_width': 0.004162687401954372, 'prediction_confidence': 0.6, 'prediction_stability': 0.6, 'market_score': 5, 'raw_prediction': 3.9979044237246683e-07, 'scaled_prediction': 0.0001998952211862334}",-51.8,46,457.9808305951235
2025-06-05 09:45:00,2025-06-05 10:00:00,BUY,3366.09,3370.84,0.01,47.5,take_profit,1,"{'rsi_14': 53.278239841407064, 'adx': 11.498533705169242, 'trend_strength': 0.11498533705169242, 'volatility_ratio': 0.0014112598380760452, 'bb_width': 0.004162687401954372, 'prediction_confidence': 0.6, 'prediction_stability': 0.6, 'market_score': 5, 'raw_prediction': 2.3150317422320623e-07, 'scaled_prediction': 0.00011575158711160312}",95.0,47,505.4808305951235
2025-06-05 12:00:00,2025-06-05 12:15:00,BUY,3378.48,3387.69,0.01,92.1,take_profit,1,"{'rsi_14': 53.278239841407064, 'adx': 11.498533705169242, 'trend_strength': 0.11498533705169242, 'volatility_ratio': 0.0014112598380760452, 'bb_width': 0.004162687401954372, 'prediction_confidence': 0.6, 'prediction_stability': 0.6, 'market_score': 5, 'raw_prediction': 9.846493778114739e-08, 'scaled_prediction': 4.923246889057369e-05}",184.2,48,597.5808305951235
2025-06-05 12:30:00,2025-06-05 12:45:00,BUY,3385.2,3389.5,0.01,43.0,take_profit,1,"{'rsi_14': 53.278239841407064, 'adx': 11.498533705169242, 'trend_strength': 0.11498533705169242, 'volatility_ratio': 0.0014112598380760452, 'bb_width': 0.004162687401954372, 'prediction_confidence': 0.6, 'prediction_stability': 0.6, 'market_score': 5, 'raw_prediction': 2.211733371705661e-07, 'scaled_prediction': 0.00011058666858528304}",86.0,49,640.5808305951235
2025-06-05 13:00:00,2025-06-05 13:15:00,BUY,3391.05,3395.15,0.01,41.0,take_profit,1,"{'rsi_14': 53.278239841407064, 'adx': 11.498533705169242, 'trend_strength': 0.11498533705169242, 'volatility_ratio': 0.0014112598380760452, 'bb_width': 0.004162687401954372, 'prediction_confidence': 0.6, 'prediction_stability': 0.6, 'market_score': 5, 'raw_prediction': 1.6595590563506648e-07, 'scaled_prediction': 8.297795281753324e-05}",82.0,50,681.5808305951235
2025-06-05 13:30:00,2025-06-05 14:00:00,BUY,3398.03,3402.4,0.01,43.7,take_profit,3,"{'rsi_14': 53.278239841407064, 'adx': 11.498533705169242, 'trend_strength': 0.11498533705169242, 'volatility_ratio': 0.0014112598380760452, 'bb_width': 0.004162687401954372, 'prediction_confidence': 0.6, 'prediction_stability': 0.6, 'market_score': 5, 'raw_prediction': 5.5683153912185e-07, 'scaled_prediction': 0.000278415769560925}",87.4,51,725.2808305951236
2025-06-05 14:15:00,2025-06-05 14:45:00,BUY,3395.19,3392.34,0.01,-28.5,stop_loss,3,"{'rsi_14': 53.278239841407064, 'adx': 11.498533705169242, 'trend_strength': 0.11498533705169242, 'volatility_ratio': 0.0014112598380760452, 'bb_width': 0.004162687401954372, 'prediction_confidence': 0.6, 'prediction_stability': 0.6, 'market_score': 5, 'raw_prediction': 4.2772133017356904e-07, 'scaled_prediction': 0.00021386066508678452}",-57.0,52,696.7808305951236
2025-06-05 15:00:00,2025-06-05 15:30:00,BUY,3395.5,3394.07,0.01,-14.3,stop_loss,3,"{'rsi_14': 53.278239841407064, 'adx': 11.498533705169242, 'trend_strength': 0.11498533705169242, 'volatility_ratio': 0.0014112598380760452, 'bb_width': 0.004162687401954372, 'prediction_confidence': 0.6, 'prediction_stability': 0.6, 'market_score': 5, 'raw_prediction': 2.8820318404972444e-07, 'scaled_prediction': 0.00014410159202486223}",-28.6,53,682.4808305951236
2025-06-05 15:45:00,2025-06-05 16:00:00,BUY,3382.87,3381.5,0.01,-13.7,stop_loss,1,"{'rsi_14': 53.278239841407064, 'adx': 11.498533705169242, 'trend_strength': 0.11498533705169242, 'volatility_ratio': 0.0014112598380760452, 'bb_width': 0.004162687401954372, 'prediction_confidence': 0.6, 'prediction_stability': 0.6, 'market_score': 5, 'raw_prediction': 3.923983604377283e-07, 'scaled_prediction': 0.00019619918021886415}",-27.4,54,668.7808305951236
2025-06-05 16:45:00,2025-06-05 17:00:00,BUY,3378.17,3375.07,0.01,-31.0,stop_loss,1,"{'rsi_14': 53.278239841407064, 'adx': 11.498533705169242, 'trend_strength': 0.11498533705169242, 'volatility_ratio': 0.0014112598380760452, 'bb_width': 0.004162687401954372, 'prediction_confidence': 0.6, 'prediction_stability': 0.6, 'market_score': 5, 'raw_prediction': 1.6562768728377463e-07, 'scaled_prediction': 8.281384364188731e-05}",-62.0,55,637.7808305951236
2025-06-05 17:15:00,2025-06-05 17:30:00,BUY,3375.59,3374.17,0.01,-14.2,stop_loss,1,"{'rsi_14': 53.278239841407064, 'adx': 11.498533705169242, 'trend_strength': 0.11498533705169242, 'volatility_ratio': 0.0014112598380760452, 'bb_width': 0.004162687401954372, 'prediction_confidence': 0.6, 'prediction_stability': 0.6, 'market_score': 5, 'raw_prediction': 7.063068902609407e-08, 'scaled_prediction': 3.5315344513047034e-05}",-28.4,56,623.5808305951235
2025-06-05 18:00:00,2025-06-05 18:15:00,BUY,3367.61,3362.51,0.01,-51.0,stop_loss,1,"{'rsi_14': 53.278239841407064, 'adx': 11.498533705169242, 'trend_strength': 0.11498533705169242, 'volatility_ratio': 0.0014112598380760452, 'bb_width': 0.004162687401954372, 'prediction_confidence': 0.6, 'prediction_stability': 0.6, 'market_score': 5, 'raw_prediction': 6.266427218517422e-08, 'scaled_prediction': 3.133213609258711e-05}",-102.0,57,572.5808305951235
2025-06-05 18:30:00,2025-06-05 18:45:00,BUY,3350.76,3344.85,0.01,-59.1,stop_loss,1,"{'rsi_14': 53.278239841407064, 'adx': 11.498533705169242, 'trend_strength': 0.11498533705169242, 'volatility_ratio': 0.0014112598380760452, 'bb_width': 0.004162687401954372, 'prediction_confidence': 0.6, 'prediction_stability': 0.6, 'market_score': 5, 'raw_prediction': 1.0971954898626611e-07, 'scaled_prediction': 5.4859774493133056e-05}",-118.2,58,513.4808305951235
2025-06-05 19:00:00,2025-06-05 19:15:00,BUY,3349.96,3348.03,0.01,-19.3,stop_loss,1,"{'rsi_14': 53.278239841407064, 'adx': 11.498533705169242, 'trend_strength': 0.11498533705169242, 'volatility_ratio': 0.0014112598380760452, 'bb_width': 0.004162687401954372, 'prediction_confidence': 0.6, 'prediction_stability': 0.6, 'market_score': 5, 'raw_prediction': 4.579875968028746e-07, 'scaled_prediction': 0.00022899379840143728}",-38.6,59,494.1808305951235
2025-06-05 19:30:00,2025-06-05 19:45:00,BUY,3350.19,3354.18,0.01,39.9,take_profit,1,"{'rsi_14': 53.278239841407064, 'adx': 11.498533705169242, 'trend_strength': 0.11498533705169242, 'volatility_ratio': 0.0014112598380760452, 'bb_width': 0.004162687401954372, 'prediction_confidence': 0.6, 'prediction_stability': 0.6, 'market_score': 5, 'raw_prediction': 5.282622879524758e-07, 'scaled_prediction': 0.0002641311439762379}",79.8,60,534.0808305951235
2025-06-05 20:00:00,2025-06-05 20:15:00,BUY,3349.98,3352.68,0.01,27.0,take_profit,1,"{'rsi_14': 53.278239841407064, 'adx': 11.498533705169242, 'trend_strength': 0.11498533705169242, 'volatility_ratio': 0.0014112598380760452, 'bb_width': 0.004162687401954372, 'prediction_confidence': 0.6, 'prediction_stability': 0.6, 'market_score': 5, 'raw_prediction': 4.32710425230525e-07, 'scaled_prediction': 0.0002163552126152625}",54.0,61,561.0808305951235
2025-06-05 20:30:00,2025-06-05 21:15:00,BUY,3352.22,3355.12,0.01,29.0,take_profit,5,"{'rsi_14': 53.278239841407064, 'adx': 11.498533705169242, 'trend_strength': 0.11498533705169242, 'volatility_ratio': 0.0014112598380760452, 'bb_width': 0.004162687401954372, 'prediction_confidence': 0.6, 'prediction_stability': 0.6, 'market_score': 5, 'raw_prediction': 3.0714101757349373e-07, 'scaled_prediction': 0.00015357050878674687}",58.0,62,590.0808305951235
2025-06-05 21:30:00,2025-06-05 22:15:00,BUY,3353.99,3357.69,0.01,37.0,take_profit,5,"{'rsi_14': 53.278239841407064, 'adx': 11.498533705169242, 'trend_strength': 0.11498533705169242, 'volatility_ratio': 0.0014112598380760452, 'bb_width': 0.004162687401954372, 'prediction_confidence': 0.6, 'prediction_stability': 0.6, 'market_score': 5, 'raw_prediction': 2.864698471308952e-07, 'scaled_prediction': 0.0001432349235654476}",74.0,63,627.0808305951235
2025-06-05 22:30:00,2025-06-05 23:15:00,BUY,3357.04,3353.87,0.01,-31.7,stop_loss,5,"{'rsi_14': 53.278239841407064, 'adx': 11.498533705169242, 'trend_strength': 0.11498533705169242, 'volatility_ratio': 0.0014112598380760452, 'bb_width': 0.004162687401954372, 'prediction_confidence': 0.6, 'prediction_stability': 0.6, 'market_score': 5, 'raw_prediction': 1.8965640641504067e-07, 'scaled_prediction': 9.482820320752033e-05}",-63.4,64,595.3808305951235
2025-06-05 23:30:00,2025-06-05 23:45:00,BUY,3354.05,3352.66,0.01,-13.9,stop_loss,1,"{'rsi_14': 53.278239841407064, 'adx': 11.498533705169242, 'trend_strength': 0.11498533705169242, 'volatility_ratio': 0.0014112598380760452, 'bb_width': 0.004162687401954372, 'prediction_confidence': 0.6, 'prediction_stability': 0.6, 'market_score': 5, 'raw_prediction': 1.6648470779283826e-07, 'scaled_prediction': 8.324235389641913e-05}",-27.8,65,581.4808305951235
2025-06-06 01:00:00,2025-06-06 01:15:00,BUY,3355.86,3360.64,0.01,47.8,take_profit,1,"{'rsi_14': 53.278239841407064, 'adx': 11.498533705169242, 'trend_strength': 0.11498533705169242, 'volatility_ratio': 0.0014112598380760452, 'bb_width': 0.004162687401954372, 'prediction_confidence': 0.6, 'prediction_stability': 0.6, 'market_score': 5, 'raw_prediction': 1.4627502228745826e-07, 'scaled_prediction': 7.313751114372914e-05}",95.6,66,629.2808305951235
2025-06-06 01:30:00,2025-06-06 02:45:00,BUY,3358.59,3361.79,0.01,32.0,take_profit,9,"{'rsi_14': 53.278239841407064, 'adx': 11.498533705169242, 'trend_strength': 0.11498533705169242, 'volatility_ratio': 0.0014112598380760452, 'bb_width': 0.004162687401954372, 'prediction_confidence': 0.6, 'prediction_stability': 0.6, 'market_score': 5, 'raw_prediction': 1.4255053253685593e-07, 'scaled_prediction': 7.127526626842796e-05}",64.0,67,661.2808305951235
2025-06-06 03:00:00,2025-06-06 03:30:00,BUY,3363.87,3361.26,0.01,-26.1,stop_loss,3,"{'rsi_14': 53.278239841407064, 'adx': 11.498533705169242, 'trend_strength': 0.11498533705169242, 'volatility_ratio': 0.0014112598380760452, 'bb_width': 0.004162687401954372, 'prediction_confidence': 0.6, 'prediction_stability': 0.6, 'market_score': 5, 'raw_prediction': 1.413326535711107e-07, 'scaled_prediction': 7.066632678555534e-05}",-52.2,68,635.1808305951234
2025-06-06 03:45:00,2025-06-06 04:15:00,BUY,3359.5,3368.12,0.01,86.2,take_profit,3,"{'rsi_14': 53.278239841407064, 'adx': 11.498533705169242, 'trend_strength': 0.11498533705169242, 'volatility_ratio': 0.0014112598380760452, 'bb_width': 0.004162687401954372, 'prediction_confidence': 0.6, 'prediction_stability': 0.6, 'market_score': 5, 'raw_prediction': 3.3154120314758187e-07, 'scaled_prediction': 0.00016577060157379092}",172.4,69,721.3808305951235
2025-06-06 04:45:00,2025-06-06 06:00:00,BUY,3363.9,3361.47,0.01,-24.3,stop_loss,9,"{'rsi_14': 53.278239841407064, 'adx': 11.498533705169242, 'trend_strength': 0.11498533705169242, 'volatility_ratio': 0.0014112598380760452, 'bb_width': 0.004162687401954372, 'prediction_confidence': 0.6, 'prediction_stability': 0.6, 'market_score': 5, 'raw_prediction': 1.7538499392300906e-07, 'scaled_prediction': 8.769249696150453e-05}",-48.6,70,697.0808305951235
2025-06-06 06:15:00,2025-06-06 06:30:00,BUY,3366.47,3370.08,0.01,36.1,take_profit,1,"{'rsi_14': 53.278239841407064, 'adx': 11.498533705169242, 'trend_strength': 0.11498533705169242, 'volatility_ratio': 0.0014112598380760452, 'bb_width': 0.004162687401954372, 'prediction_confidence': 0.6, 'prediction_stability': 0.6, 'market_score': 5, 'raw_prediction': 1.837113086101186e-07, 'scaled_prediction': 9.18556543050593e-05}",72.2,71,733.1808305951236
2025-06-06 06:45:00,2025-06-06 07:45:00,BUY,3369.49,3373.45,0.01,39.6,take_profit,7,"{'rsi_14': 53.278239841407064, 'adx': 11.498533705169242, 'trend_strength': 0.11498533705169242, 'volatility_ratio': 0.0014112598380760452, 'bb_width': 0.004162687401954372, 'prediction_confidence': 0.6, 'prediction_stability': 0.6, 'market_score': 5, 'raw_prediction': 1.021969220891849e-07, 'scaled_prediction': 5.109846104459245e-05}",79.2,72,772.7808305951236
2025-06-06 08:00:00,2025-06-06 08:15:00,BUY,3373.71,3369.39,0.01,-43.2,stop_loss,1,"{'rsi_14': 53.278239841407064, 'adx': 11.498533705169242, 'trend_strength': 0.11498533705169242, 'volatility_ratio': 0.0014112598380760452, 'bb_width': 0.004162687401954372, 'prediction_confidence': 0.6, 'prediction_stability': 0.6, 'market_score': 5, 'raw_prediction': 1.390455143771433e-07, 'scaled_prediction': 6.952275718857165e-05}",-86.4,73,729.5808305951235
2025-06-06 08:30:00,2025-06-06 09:00:00,BUY,3366.26,3362.75,0.01,-35.1,stop_loss,3,"{'rsi_14': 53.278239841407064, 'adx': 11.498533705169242, 'trend_strength': 0.11498533705169242, 'volatility_ratio': 0.0014112598380760452, 'bb_width': 0.004162687401954372, 'prediction_confidence': 0.6, 'prediction_stability': 0.6, 'market_score': 5, 'raw_prediction': 3.330387694088876e-08, 'scaled_prediction': 1.6651938470444382e-05}",-70.2,74,694.4808305951235
2025-06-06 09:15:00,2025-06-06 09:30:00,BUY,3364.94,3358.45,0.01,-64.9,stop_loss,1,"{'rsi_14': 53.278239841407064, 'adx': 11.498533705169242, 'trend_strength': 0.11498533705169242, 'volatility_ratio': 0.0014112598380760452, 'bb_width': 0.004162687401954372, 'prediction_confidence': 0.6, 'prediction_stability': 0.6, 'market_score': 5, 'raw_prediction': 6.3416737260731e-08, 'scaled_prediction': 3.17083686303655e-05}",-129.8,75,629.5808305951235
2025-06-06 10:15:00,2025-06-06 10:30:00,BUY,3360.44,3359.22,0.01,-12.2,stop_loss,1,"{'rsi_14': 53.278239841407064, 'adx': 11.498533705169242, 'trend_strength': 0.11498533705169242, 'volatility_ratio': 0.0014112598380760452, 'bb_width': 0.004162687401954372, 'prediction_confidence': 0.6, 'prediction_stability': 0.6, 'market_score': 5, 'raw_prediction': 3.064399061351985e-07, 'scaled_prediction': 0.00015321995306759924}",-24.4,76,617.3808305951235
2025-06-06 10:45:00,2025-06-06 11:15:00,BUY,3359.39,3363.71,0.01,43.2,take_profit,3,"{'rsi_14': 53.278239841407064, 'adx': 11.498533705169242, 'trend_strength': 0.11498533705169242, 'volatility_ratio': 0.0014112598380760452, 'bb_width': 0.004162687401954372, 'prediction_confidence': 0.6, 'prediction_stability': 0.6, 'market_score': 5, 'raw_prediction': 1.945619877883952e-07, 'scaled_prediction': 9.72809938941976e-05}",86.4,77,660.5808305951235
2025-06-06 11:30:00,2025-06-06 11:45:00,BUY,3366.89,3365.31,0.01,-15.8,stop_loss,1,"{'rsi_14': 53.278239841407064, 'adx': 11.498533705169242, 'trend_strength': 0.11498533705169242, 'volatility_ratio': 0.0014112598380760452, 'bb_width': 0.004162687401954372, 'prediction_confidence': 0.6, 'prediction_stability': 0.6, 'market_score': 5, 'raw_prediction': 3.5277666767939104e-07, 'scaled_prediction': 0.00017638833383969553}",-31.6,78,644.7808305951236
2025-06-06 12:00:00,2025-06-06 12:15:00,BUY,3360.54,3355.59,0.01,-49.5,stop_loss,1,"{'rsi_14': 53.278239841407064, 'adx': 11.498533705169242, 'trend_strength': 0.11498533705169242, 'volatility_ratio': 0.0014112598380760452, 'bb_width': 0.004162687401954372, 'prediction_confidence': 0.6, 'prediction_stability': 0.6, 'market_score': 5, 'raw_prediction': 3.3133805853823083e-07, 'scaled_prediction': 0.0001656690292691154}",-99.0,79,595.2808305951236
2025-06-06 12:30:00,2025-06-06 13:45:00,BUY,3357.15,3360.32,0.01,31.7,take_profit,9,"{'rsi_14': 53.278239841407064, 'adx': 11.498533705169242, 'trend_strength': 0.11498533705169242, 'volatility_ratio': 0.0014112598380760452, 'bb_width': 0.004162687401954372, 'prediction_confidence': 0.6, 'prediction_stability': 0.6, 'market_score': 5, 'raw_prediction': 5.217401193044625e-07, 'scaled_prediction': 0.00026087005965223125}",63.4,80,626.9808305951236
2025-06-06 14:00:00,2025-06-06 14:45:00,BUY,3361.49,3358.45,0.01,-30.4,stop_loss,5,"{'rsi_14': 53.278239841407064, 'adx': 11.498533705169242, 'trend_strength': 0.11498533705169242, 'volatility_ratio': 0.0014112598380760452, 'bb_width': 0.004162687401954372, 'prediction_confidence': 0.6, 'prediction_stability': 0.6, 'market_score': 5, 'raw_prediction': 4.586870490664116e-07, 'scaled_prediction': 0.00022934352453320579}",-60.8,81,596.5808305951236
2025-06-06 15:00:00,2025-06-06 15:15:00,BUY,3356.23,3358.74,0.01,25.1,take_profit,1,"{'rsi_14': 53.278239841407064, 'adx': 11.498533705169242, 'trend_strength': 0.11498533705169242, 'volatility_ratio': 0.0014112598380760452, 'bb_width': 0.004162687401954372, 'prediction_confidence': 0.6, 'prediction_stability': 0.6, 'market_score': 5, 'raw_prediction': 4.4244495796259055e-07, 'scaled_prediction': 0.00022122247898129528}",50.2,82,621.6808305951237
2025-06-06 15:30:00,2025-06-06 16:30:00,BUY,3353.26,3346.86,0.01,-64.0,stop_loss,7,"{'rsi_14': 53.278239841407064, 'adx': 11.498533705169242, 'trend_strength': 0.11498533705169242, 'volatility_ratio': 0.0014112598380760452, 'bb_width': 0.004162687401954372, 'prediction_confidence': 0.6, 'prediction_stability': 0.6, 'market_score': 5, 'raw_prediction': 4.2973406388830187e-07, 'scaled_prediction': 0.00021486703194415093}",-128.0,83,557.6808305951237
2025-06-06 16:45:00,2025-06-06 17:00:00,BUY,3343.12,3333.93,0.01,-66.92169967141484,daily_loss_limit,1,"{'rsi_14': 53.278239841407064, 'adx': 11.498533705169242, 'trend_strength': 0.11498533705169242, 'volatility_ratio': 0.0014112598380760452, 'bb_width': 0.004162687401954372, 'prediction_confidence': 0.6, 'prediction_stability': 0.6, 'market_score': 5, 'raw_prediction': 4.14817565008629e-07, 'scaled_prediction': 0.0002074087825043145}",-158.82169967141485,84,490.7591309237088
2025-06-06 17:00:00,2025-06-06 17:15:00,BUY,3333.93,3323.93,0.01,-58.89109571084506,daily_loss_limit,1,"{'rsi_14': 53.278239841407064, 'adx': 11.498533705169242, 'trend_strength': 0.11498533705169242, 'volatility_ratio': 0.0014112598380760452, 'bb_width': 0.004162687401954372, 'prediction_confidence': 0.6, 'prediction_stability': 0.6, 'market_score': 5, 'raw_prediction': 4.106004781169661e-07, 'scaled_prediction': 0.00020530023905848305}",-158.89109571084506,85,431.8680352128638
2025-06-06 17:15:00,2025-06-06 17:30:00,BUY,3323.93,3333.54,0.01,96.1,take_profit,1,"{'rsi_14': 53.278239841407064, 'adx': 11.498533705169242, 'trend_strength': 0.11498533705169242, 'volatility_ratio': 0.0014112598380760452, 'bb_width': 0.004162687401954372, 'prediction_confidence': 0.6, 'prediction_stability': 0.6, 'market_score': 5, 'raw_prediction': 4.0496294965342345e-07, 'scaled_prediction': 0.00020248147482671174}",192.2,86,527.9680352128638
2025-06-06 17:45:00,2025-06-06 18:00:00,BUY,3326.25,3323.93,0.01,-23.2,stop_loss,1,"{'rsi_14': 53.278239841407064, 'adx': 11.498533705169242, 'trend_strength': 0.11498533705169242, 'volatility_ratio': 0.0014112598380760452, 'bb_width': 0.004162687401954372, 'prediction_confidence': 0.6, 'prediction_stability': 0.6, 'market_score': 5, 'raw_prediction': 3.891265951862614e-07, 'scaled_prediction': 0.0001945632975931307}",-46.4,87,504.7680352128638
2025-06-06 18:15:00,2025-06-06 18:30:00,BUY,3330.82,3333.76,0.01,29.4,take_profit,1,"{'rsi_14': 53.278239841407064, 'adx': 11.498533705169242, 'trend_strength': 0.11498533705169242, 'volatility_ratio': 0.0014112598380760452, 'bb_width': 0.004162687401954372, 'prediction_confidence': 0.6, 'prediction_stability': 0.6, 'market_score': 5, 'raw_prediction': 3.664526158534213e-07, 'scaled_prediction': 0.00018322630792671064}",58.8,88,534.1680352128639
2025-06-06 18:45:00,2025-06-06 19:00:00,BUY,3331.94,3329.42,0.01,-25.2,stop_loss,1,"{'rsi_14': 53.278239841407064, 'adx': 11.498533705169242, 'trend_strength': 0.11498533705169242, 'volatility_ratio': 0.0014112598380760452, 'bb_width': 0.004162687401954372, 'prediction_confidence': 0.6, 'prediction_stability': 0.6, 'market_score': 5, 'raw_prediction': 3.3800801601041157e-07, 'scaled_prediction': 0.0001690040080052058}",-50.4,89,508.96803521286387
2025-06-06 19:15:00,2025-06-06 19:45:00,BUY,3324.03,3322.53,0.01,-15.0,stop_loss,3,"{'rsi_14': 53.278239841407064, 'adx': 11.498533705169242, 'trend_strength': 0.11498533705169242, 'volatility_ratio': 0.0014112598380760452, 'bb_width': 0.004162687401954372, 'prediction_confidence': 0.6, 'prediction_stability': 0.6, 'market_score': 5, 'raw_prediction': 3.211776202823571e-07, 'scaled_prediction': 0.00016058881014117856}",-30.0,90,493.96803521286387
2025-06-06 20:00:00,2025-06-06 20:15:00,BUY,3325.67,3324.0,0.01,-16.7,stop_loss,1,"{'rsi_14': 53.278239841407064, 'adx': 11.498533705169242, 'trend_strength': 0.11498533705169242, 'volatility_ratio': 0.0014112598380760452, 'bb_width': 0.004162687401954372, 'prediction_confidence': 0.6, 'prediction_stability': 0.6, 'market_score': 5, 'raw_prediction': 2.713914146069086e-07, 'scaled_prediction': 0.0001356957073034543}",-33.4,91,477.2680352128639
2025-06-06 20:30:00,2025-06-06 21:00:00,BUY,3322.14,3315.29,0.01,-57.27216422554366,daily_loss_limit,3,"{'rsi_14': 53.278239841407064, 'adx': 11.498533705169242, 'trend_strength': 0.11498533705169242, 'volatility_ratio': 0.0014112598380760452, 'bb_width': 0.004162687401954372, 'prediction_confidence': 0.6, 'prediction_stability': 0.6, 'market_score': 5, 'raw_prediction': 2.414633200468131e-07, 'scaled_prediction': 0.00012073166002340654}",-125.77216422554366,92,419.9958709873202
2025-06-06 21:00:00,2025-06-06 21:30:00,BUY,3315.29,3319.43,0.01,41.4,take_profit,3,"{'rsi_14': 53.278239841407064, 'adx': 11.498533705169242, 'trend_strength': 0.11498533705169242, 'volatility_ratio': 0.0014112598380760452, 'bb_width': 0.004162687401954372, 'prediction_confidence': 0.6, 'prediction_stability': 0.6, 'market_score': 5, 'raw_prediction': 2.4479368577585876e-07, 'scaled_prediction': 0.0001223968428879294}",82.8,93,461.39587098732017
2025-06-06 21:45:00,2025-06-06 22:15:00,BUY,3317.22,3315.08,0.01,-21.4,stop_loss,3,"{'rsi_14': 53.278239841407064, 'adx': 11.498533705169242, 'trend_strength': 0.11498533705169242, 'volatility_ratio': 0.0014112598380760452, 'bb_width': 0.004162687401954372, 'prediction_confidence': 0.6, 'prediction_stability': 0.6, 'market_score': 5, 'raw_prediction': 2.4293070594200936e-07, 'scaled_prediction': 0.00012146535297100468}",-42.8,94,439.9958709873202
2025-06-06 22:30:00,2025-06-06 22:45:00,BUY,3315.77,3312.46,0.01,-33.1,stop_loss,1,"{'rsi_14': 53.278239841407064, 'adx': 11.498533705169242, 'trend_strength': 0.11498533705169242, 'volatility_ratio': 0.0014112598380760452, 'bb_width': 0.004162687401954372, 'prediction_confidence': 0.6, 'prediction_stability': 0.6, 'market_score': 5, 'raw_prediction': 2.6712598626209654e-07, 'scaled_prediction': 0.00013356299313104826}",-66.2,95,406.89587098732017
2025-06-06 23:00:00,2025-06-06 23:15:00,BUY,3307.53,3311.19,0.01,36.6,take_profit,1,"{'rsi_14': 53.278239841407064, 'adx': 11.498533705169242, 'trend_strength': 0.11498533705169242, 'volatility_ratio': 0.0014112598380760452, 'bb_width': 0.004162687401954372, 'prediction_confidence': 0.6, 'prediction_stability': 0.6, 'market_score': 5, 'raw_prediction': 2.7763811513636964e-07, 'scaled_prediction': 0.00013881905756818482}",73.2,96,443.4958709873202
2025-06-06 23:30:00,2025-06-06 23:45:00,BUY,3310.85,3309.56,0.01,-12.9,stop_loss,1,"{'rsi_14': 53.278239841407064, 'adx': 11.498533705169242, 'trend_strength': 0.11498533705169242, 'volatility_ratio': 0.0014112598380760452, 'bb_width': 0.004162687401954372, 'prediction_confidence': 0.6, 'prediction_stability': 0.6, 'market_score': 5, 'raw_prediction': 3.4178028007740493e-07, 'scaled_prediction': 0.00017089014003870246}",-25.8,97,430.5958709873202
2025-06-09 01:00:00,2025-06-09 01:30:00,BUY,3317.25,3312.24,0.01,-50.1,stop_loss,3,"{'rsi_14': 53.278239841407064, 'adx': 11.498533705169242, 'trend_strength': 0.11498533705169242, 'volatility_ratio': 0.0014112598380760452, 'bb_width': 0.004162687401954372, 'prediction_confidence': 0.6, 'prediction_stability': 0.6, 'market_score': 5, 'raw_prediction': 3.8681997088538037e-07, 'scaled_prediction': 0.0001934099854426902}",-100.2,98,380.4958709873202
2025-06-09 01:45:00,2025-06-09 02:45:00,BUY,3314.88,3317.91,0.01,30.3,take_profit,7,"{'rsi_14': 53.278239841407064, 'adx': 11.498533705169242, 'trend_strength': 0.11498533705169242, 'volatility_ratio': 0.0014112598380760452, 'bb_width': 0.004162687401954372, 'prediction_confidence': 0.6, 'prediction_stability': 0.6, 'market_score': 5, 'raw_prediction': 3.9012377976124577e-07, 'scaled_prediction': 0.0001950618898806229}",60.6,99,410.7958709873202
2025-06-09 03:00:00,2025-06-09 03:15:00,BUY,3311.87,3309.84,0.01,-20.3,stop_loss,1,"{'rsi_14': 53.278239841407064, 'adx': 11.498533705169242, 'trend_strength': 0.11498533705169242, 'volatility_ratio': 0.0014112598380760452, 'bb_width': 0.004162687401954372, 'prediction_confidence': 0.6, 'prediction_stability': 0.6, 'market_score': 5, 'raw_prediction': 2.700745535742546e-07, 'scaled_prediction': 0.0001350372767871273}",-40.6,100,390.4958709873202
2025-06-09 03:30:00,2025-06-09 03:45:00,BUY,3302.66,3305.2,0.01,25.4,take_profit,1,"{'rsi_14': 53.278239841407064, 'adx': 11.498533705169242, 'trend_strength': 0.11498533705169242, 'volatility_ratio': 0.0014112598380760452, 'bb_width': 0.004162687401954372, 'prediction_confidence': 0.6, 'prediction_stability': 0.6, 'market_score': 5, 'raw_prediction': 4.246496536306265e-07, 'scaled_prediction': 0.00021232482681531325}",50.8,101,415.89587098732017
2025-06-09 04:00:00,2025-06-09 04:45:00,BUY,3305.69,3296.03,0.01,-49.90750451847842,daily_loss_limit,5,"{'rsi_14': 53.278239841407064, 'adx': 11.498533705169242, 'trend_strength': 0.11498533705169242, 'volatility_ratio': 0.0014112598380760452, 'bb_width': 0.004162687401954372, 'prediction_confidence': 0.6, 'prediction_stability': 0.6, 'market_score': 5, 'raw_prediction': 4.8841218849991816e-08, 'scaled_prediction': 2.4420609424995907e-05}",-146.5075045184784,102,365.9883664688418
2025-06-09 04:45:00,2025-06-09 05:15:00,BUY,3296.03,3301.87,0.01,58.4,take_profit,3,"{'rsi_14': 53.278239841407064, 'adx': 11.498533705169242, 'trend_strength': 0.11498533705169242, 'volatility_ratio': 0.0014112598380760452, 'bb_width': 0.004162687401954372, 'prediction_confidence': 0.6, 'prediction_stability': 0.6, 'market_score': 5, 'raw_prediction': 4.8841218815353376e-08, 'scaled_prediction': 2.442060940767669e-05}",116.8,103,424.38836646884175
2025-06-09 05:30:00,2025-06-09 05:45:00,BUY,3302.57,3305.58,0.01,30.1,take_profit,1,"{'rsi_14': 53.278239841407064, 'adx': 11.498533705169242, 'trend_strength': 0.11498533705169242, 'volatility_ratio': 0.0014112598380760452, 'bb_width': 0.004162687401954372, 'prediction_confidence': 0.6, 'prediction_stability': 0.6, 'market_score': 5, 'raw_prediction': 4.884121888928606e-08, 'scaled_prediction': 2.442060944464303e-05}",60.2,104,454.4883664688418
2025-06-09 06:00:00,2025-06-09 06:15:00,BUY,3307.43,3304.42,0.01,-30.1,stop_loss,1,"{'rsi_14': 53.278239841407064, 'adx': 11.498533705169242, 'trend_strength': 0.11498533705169242, 'volatility_ratio': 0.0014112598380760452, 'bb_width': 0.004162687401954372, 'prediction_confidence': 0.6, 'prediction_stability': 0.6, 'market_score': 5, 'raw_prediction': 4.884121882546584e-08, 'scaled_prediction': 2.442060941273292e-05}",-60.2,105,424.38836646884175
2025-06-09 06:30:00,2025-06-09 07:15:00,BUY,3308.56,3311.91,0.01,33.5,take_profit,5,"{'rsi_14': 53.278239841407064, 'adx': 11.498533705169242, 'trend_strength': 0.11498533705169242, 'volatility_ratio': 0.0014112598380760452, 'bb_width': 0.004162687401954372, 'prediction_confidence': 0.6, 'prediction_stability': 0.6, 'market_score': 5, 'raw_prediction': 4.88412189130311e-08, 'scaled_prediction': 2.442060945651555e-05}",67.0,106,457.88836646884175
2025-06-09 07:30:00,2025-06-09 08:30:00,BUY,3312.04,3315.06,0.01,30.2,take_profit,7,"{'rsi_14': 53.278239841407064, 'adx': 11.498533705169242, 'trend_strength': 0.11498533705169242, 'volatility_ratio': 0.0014112598380760452, 'bb_width': 0.004162687401954372, 'prediction_confidence': 0.6, 'prediction_stability': 0.6, 'market_score': 5, 'raw_prediction': 4.884121886398117e-08, 'scaled_prediction': 2.4420609431990583e-05}",60.4,107,488.08836646884174
2025-06-09 08:45:00,2025-06-09 09:15:00,BUY,3314.37,3318.7,0.01,43.3,take_profit,3,"{'rsi_14': 53.278239841407064, 'adx': 11.498533705169242, 'trend_strength': 0.11498533705169242, 'volatility_ratio': 0.0014112598380760452, 'bb_width': 0.004162687401954372, 'prediction_confidence': 0.6, 'prediction_stability': 0.6, 'market_score': 5, 'raw_prediction': 4.884121887299009e-08, 'scaled_prediction': 2.4420609436495044e-05}",86.6,108,531.3883664688417
2025-06-09 09:30:00,2025-06-09 09:45:00,BUY,3320.09,3324.16,0.01,40.7,take_profit,1,"{'rsi_14': 53.278239841407064, 'adx': 11.498533705169242, 'trend_strength': 0.11498533705169242, 'volatility_ratio': 0.0014112598380760452, 'bb_width': 0.004162687401954372, 'prediction_confidence': 0.6, 'prediction_stability': 0.6, 'market_score': 5, 'raw_prediction': 4.884121886977537e-08, 'scaled_prediction': 2.4420609434887683e-05}",81.4,109,572.0883664688417
2025-06-09 10:00:00,2025-06-09 11:45:00,BUY,3323.54,3319.87,0.01,-36.7,stop_loss,13,"{'rsi_14': 53.278239841407064, 'adx': 11.498533705169242, 'trend_strength': 0.11498533705169242, 'volatility_ratio': 0.0014112598380760452, 'bb_width': 0.004162687401954372, 'prediction_confidence': 0.6, 'prediction_stability': 0.6, 'market_score': 5, 'raw_prediction': 4.884121883315681e-08, 'scaled_prediction': 2.4420609416578406e-05}",-73.4,110,535.3883664688417
2025-06-09 12:00:00,2025-06-09 12:15:00,BUY,3322.91,3318.39,0.01,-45.2,stop_loss,1,"{'rsi_14': 53.278239841407064, 'adx': 11.498533705169242, 'trend_strength': 0.11498533705169242, 'volatility_ratio': 0.0014112598380760452, 'bb_width': 0.004162687401954372, 'prediction_confidence': 0.6, 'prediction_stability': 0.6, 'market_score': 5, 'raw_prediction': 4.884121881603763e-08, 'scaled_prediction': 2.4420609408018816e-05}",-90.4,111,490.1883664688417
2025-06-09 12:30:00,2025-06-09 12:45:00,BUY,3321.58,3318.76,0.01,-28.2,stop_loss,1,"{'rsi_14': 53.278239841407064, 'adx': 11.498533705169242, 'trend_strength': 0.11498533705169242, 'volatility_ratio': 0.0014112598380760452, 'bb_width': 0.004162687401954372, 'prediction_confidence': 0.6, 'prediction_stability': 0.6, 'market_score': 5, 'raw_prediction': 4.884121881029958e-08, 'scaled_prediction': 2.442060940514979e-05}",-56.4,112,461.9883664688417
2025-06-09 13:00:00,2025-06-09 13:15:00,BUY,3319.04,3316.94,0.01,-21.0,stop_loss,1,"{'rsi_14': 53.278239841407064, 'adx': 11.498533705169242, 'trend_strength': 0.11498533705169242, 'volatility_ratio': 0.0014112598380760452, 'bb_width': 0.004162687401954372, 'prediction_confidence': 0.6, 'prediction_stability': 0.6, 'market_score': 5, 'raw_prediction': 4.8841218886892297e-08, 'scaled_prediction': 2.442060944344615e-05}",-42.0,113,440.9883664688417
2025-06-09 13:30:00,2025-06-09 14:00:00,BUY,3312.66,3316.59,0.01,39.3,take_profit,3,"{'rsi_14': 53.278239841407064, 'adx': 11.498533705169242, 'trend_strength': 0.11498533705169242, 'volatility_ratio': 0.0014112598380760452, 'bb_width': 0.004162687401954372, 'prediction_confidence': 0.6, 'prediction_stability': 0.6, 'market_score': 5, 'raw_prediction': 4.884121888523293e-08, 'scaled_prediction': 2.4420609442616466e-05}",78.6,114,480.28836646884173
2025-06-09 14:15:00,2025-06-09 15:00:00,BUY,3318.24,3315.61,0.01,-26.3,stop_loss,5,"{'rsi_14': 53.278239841407064, 'adx': 11.498533705169242, 'trend_strength': 0.11498533705169242, 'volatility_ratio': 0.0014112598380760452, 'bb_width': 0.004162687401954372, 'prediction_confidence': 0.6, 'prediction_stability': 0.6, 'market_score': 5, 'raw_prediction': 4.884121880205193e-08, 'scaled_prediction': 2.4420609401025963e-05}",-52.6,115,453.9883664688417
2025-06-09 15:15:00,2025-06-09 16:00:00,BUY,3318.09,3315.76,0.01,-23.3,stop_loss,5,"{'rsi_14': 53.278239841407064, 'adx': 11.498533705169242, 'trend_strength': 0.11498533705169242, 'volatility_ratio': 0.0014112598380760452, 'bb_width': 0.004162687401954372, 'prediction_confidence': 0.6, 'prediction_stability': 0.6, 'market_score': 5, 'raw_prediction': 4.8841218863230954e-08, 'scaled_prediction': 2.4420609431615477e-05}",-46.6,116,430.6883664688417
2025-06-09 16:15:00,2025-06-09 16:45:00,BUY,3313.53,3319.05,0.01,55.2,take_profit,3,"{'rsi_14': 53.278239841407064, 'adx': 11.498533705169242, 'trend_strength': 0.11498533705169242, 'volatility_ratio': 0.0014112598380760452, 'bb_width': 0.004162687401954372, 'prediction_confidence': 0.6, 'prediction_stability': 0.6, 'market_score': 5, 'raw_prediction': 4.884121880436348e-08, 'scaled_prediction': 2.442060940218174e-05}",110.4,117,485.8883664688417
2025-06-09 17:00:00,2025-06-09 17:15:00,BUY,3325.57,3321.76,0.01,-38.1,stop_loss,1,"{'rsi_14': 53.278239841407064, 'adx': 11.498533705169242, 'trend_strength': 0.11498533705169242, 'volatility_ratio': 0.0014112598380760452, 'bb_width': 0.004162687401954372, 'prediction_confidence': 0.6, 'prediction_stability': 0.6, 'market_score': 5, 'raw_prediction': 4.884121882749996e-08, 'scaled_prediction': 2.442060941374998e-05}",-76.2,118,447.7883664688417
2025-06-09 17:30:00,2025-06-09 18:00:00,BUY,3318.35,3323.0,0.01,46.5,take_profit,3,"{'rsi_14': 53.278239841407064, 'adx': 11.498533705169242, 'trend_strength': 0.11498533705169242, 'volatility_ratio': 0.0014112598380760452, 'bb_width': 0.004162687401954372, 'prediction_confidence': 0.6, 'prediction_stability': 0.6, 'market_score': 5, 'raw_prediction': 4.884121889423102e-08, 'scaled_prediction': 2.4420609447115512e-05}",93.0,119,494.2883664688417
2025-06-09 18:15:00,2025-06-09 18:45:00,BUY,3330.39,3328.71,0.01,-16.8,stop_loss,3,"{'rsi_14': 53.278239841407064, 'adx': 11.498533705169242, 'trend_strength': 0.11498533705169242, 'volatility_ratio': 0.0014112598380760452, 'bb_width': 0.004162687401954372, 'prediction_confidence': 0.6, 'prediction_stability': 0.6, 'market_score': 5, 'raw_prediction': 4.8841218780464354e-08, 'scaled_prediction': 2.4420609390232178e-05}",-33.6,120,477.48836646884166
2025-06-09 19:00:00,2025-06-09 19:15:00,BUY,3329.62,3332.85,0.01,32.3,take_profit,1,"{'rsi_14': 53.278239841407064, 'adx': 11.498533705169242, 'trend_strength': 0.11498533705169242, 'volatility_ratio': 0.0014112598380760452, 'bb_width': 0.004162687401954372, 'prediction_confidence': 0.6, 'prediction_stability': 0.6, 'market_score': 5, 'raw_prediction': 4.884121882027149e-08, 'scaled_prediction': 2.4420609410135744e-05}",64.6,121,509.7883664688417
2025-06-09 19:30:00,2025-06-09 19:45:00,BUY,3333.03,3337.79,0.01,47.6,take_profit,1,"{'rsi_14': 53.278239841407064, 'adx': 11.498533705169242, 'trend_strength': 0.11498533705169242, 'volatility_ratio': 0.0014112598380760452, 'bb_width': 0.004162687401954372, 'prediction_confidence': 0.6, 'prediction_stability': 0.6, 'market_score': 5, 'raw_prediction': 4.8841218800049926e-08, 'scaled_prediction': 2.4420609400024963e-05}",95.2,122,557.3883664688417
2025-06-09 20:45:00,2025-06-09 22:15:00,BUY,3333.72,3331.5,0.01,-22.2,stop_loss,11,"{'rsi_14': 53.278239841407064, 'adx': 11.498533705169242, 'trend_strength': 0.11498533705169242, 'volatility_ratio': 0.0014112598380760452, 'bb_width': 0.004162687401954372, 'prediction_confidence': 0.6, 'prediction_stability': 0.6, 'market_score': 5, 'raw_prediction': 1.728828502039788e-07, 'scaled_prediction': 8.64414251019894e-05}",-44.4,123,535.1883664688417
2025-06-09 22:45:00,2025-06-09 23:15:00,BUY,3326.97,3325.54,0.01,-14.3,stop_loss,3,"{'rsi_14': 53.278239841407064, 'adx': 11.498533705169242, 'trend_strength': 0.11498533705169242, 'volatility_ratio': 0.0014112598380760452, 'bb_width': 0.004162687401954372, 'prediction_confidence': 0.6, 'prediction_stability': 0.6, 'market_score': 5, 'raw_prediction': 1.3123911049074996e-07, 'scaled_prediction': 6.561955524537498e-05}",-28.6,124,520.8883664688417
2025-06-09 23:45:00,2025-06-10 01:30:00,BUY,3325.65,3322.33,0.01,-33.2,stop_loss,5,"{'rsi_14': 53.278239841407064, 'adx': 11.498533705169242, 'trend_strength': 0.11498533705169242, 'volatility_ratio': 0.0014112598380760452, 'bb_width': 0.004162687401954372, 'prediction_confidence': 0.6, 'prediction_stability': 0.6, 'market_score': 5, 'raw_prediction': 4.9445516101840256e-08, 'scaled_prediction': 2.472275805092013e-05}",-66.4,125,487.6883664688417
2025-06-10 01:45:00,2025-06-10 02:15:00,BUY,3323.55,3326.12,0.01,25.7,take_profit,3,"{'rsi_14': 53.278239841407064, 'adx': 11.498533705169242, 'trend_strength': 0.11498533705169242, 'volatility_ratio': 0.0014112598380760452, 'bb_width': 0.004162687401954372, 'prediction_confidence': 0.6, 'prediction_stability': 0.6, 'market_score': 5, 'raw_prediction': 2.7403040432794406e-07, 'scaled_prediction': 0.00013701520216397202}",51.4,126,513.3883664688417
2025-06-10 02:30:00,2025-06-10 03:00:00,BUY,3325.46,3323.26,0.01,-22.0,stop_loss,3,"{'rsi_14': 53.278239841407064, 'adx': 11.498533705169242, 'trend_strength': 0.11498533705169242, 'volatility_ratio': 0.0014112598380760452, 'bb_width': 0.004162687401954372, 'prediction_confidence': 0.6, 'prediction_stability': 0.6, 'market_score': 5, 'raw_prediction': 4.0721797267573797e-07, 'scaled_prediction': 0.000203608986337869}",-44.0,127,491.3883664688417
2025-06-10 03:15:00,2025-06-10 03:30:00,BUY,3320.57,3315.8,0.01,-47.7,stop_loss,1,"{'rsi_14': 53.278239841407064, 'adx': 11.498533705169242, 'trend_strength': 0.11498533705169242, 'volatility_ratio': 0.0014112598380760452, 'bb_width': 0.004162687401954372, 'prediction_confidence': 0.6, 'prediction_stability': 0.6, 'market_score': 5, 'raw_prediction': 4.858219471618799e-07, 'scaled_prediction': 0.00024291097358093995}",-95.4,128,443.6883664688417
2025-06-10 03:45:00,2025-06-10 04:00:00,BUY,3316.67,3313.53,0.01,-31.4,stop_loss,1,"{'rsi_14': 53.278239841407064, 'adx': 11.498533705169242, 'trend_strength': 0.11498533705169242, 'volatility_ratio': 0.0014112598380760452, 'bb_width': 0.004162687401954372, 'prediction_confidence': 0.6, 'prediction_stability': 0.6, 'market_score': 5, 'raw_prediction': 4.646308661748429e-07, 'scaled_prediction': 0.00023231543308742145}",-62.8,129,412.28836646884173
2025-06-10 04:15:00,2025-06-10 04:30:00,BUY,3311.0,3306.74,0.01,-42.6,stop_loss,1,"{'rsi_14': 53.278239841407064, 'adx': 11.498533705169242, 'trend_strength': 0.11498533705169242, 'volatility_ratio': 0.0014112598380760452, 'bb_width': 0.004162687401954372, 'prediction_confidence': 0.6, 'prediction_stability': 0.6, 'market_score': 5, 'raw_prediction': 4.1338577289861555e-07, 'scaled_prediction': 0.00020669288644930778}",-85.2,130,369.6883664688417
2025-06-10 04:45:00,2025-06-10 05:15:00,BUY,3306.39,3303.85,0.01,-25.4,stop_loss,3,"{'rsi_14': 53.278239841407064, 'adx': 11.498533705169242, 'trend_strength': 0.11498533705169242, 'volatility_ratio': 0.0014112598380760452, 'bb_width': 0.004162687401954372, 'prediction_confidence': 0.6, 'prediction_stability': 0.6, 'market_score': 5, 'raw_prediction': 3.8795408903584404e-07, 'scaled_prediction': 0.00019397704451792203}",-50.8,131,344.28836646884173
2025-06-10 05:30:00,2025-06-10 05:45:00,BUY,3305.16,3309.1,0.01,39.4,take_profit,1,"{'rsi_14': 53.278239841407064, 'adx': 11.498533705169242, 'trend_strength': 0.11498533705169242, 'volatility_ratio': 0.0014112598380760452, 'bb_width': 0.004162687401954372, 'prediction_confidence': 0.6, 'prediction_stability': 0.6, 'market_score': 5, 'raw_prediction': 3.8070464509787664e-07, 'scaled_prediction': 0.00019035232254893832}",78.8,132,383.6883664688417
2025-06-10 06:00:00,2025-06-10 07:15:00,BUY,3305.87,3303.52,0.01,-23.5,stop_loss,9,"{'rsi_14': 53.278239841407064, 'adx': 11.498533705169242, 'trend_strength': 0.11498533705169242, 'volatility_ratio': 0.0014112598380760452, 'bb_width': 0.004162687401954372, 'prediction_confidence': 0.6, 'prediction_stability': 0.6, 'market_score': 5, 'raw_prediction': 3.8054326428980303e-07, 'scaled_prediction': 0.00019027163214490152}",-47.0,133,360.1883664688417
2025-06-10 07:30:00,2025-06-10 08:00:00,BUY,3304.85,3310.2,0.01,53.5,take_profit,3,"{'rsi_14': 53.278239841407064, 'adx': 11.498533705169242, 'trend_strength': 0.11498533705169242, 'volatility_ratio': 0.0014112598380760452, 'bb_width': 0.004162687401954372, 'prediction_confidence': 0.6, 'prediction_stability': 0.6, 'market_score': 5, 'raw_prediction': 3.8586431754694053e-07, 'scaled_prediction': 0.00019293215877347027}",107.0,134,413.6883664688417
2025-06-10 08:15:00,2025-06-10 08:30:00,BUY,3310.38,3315.66,0.01,52.8,take_profit,1,"{'rsi_14': 53.278239841407064, 'adx': 11.498533705169242, 'trend_strength': 0.11498533705169242, 'volatility_ratio': 0.0014112598380760452, 'bb_width': 0.004162687401954372, 'prediction_confidence': 0.6, 'prediction_stability': 0.6, 'market_score': 5, 'raw_prediction': 3.8693987885765583e-07, 'scaled_prediction': 0.0001934699394288279}",105.6,135,466.4883664688417
2025-06-10 08:45:00,2025-06-10 09:00:00,BUY,3317.26,3321.3,0.01,40.4,take_profit,1,"{'rsi_14': 53.278239841407064, 'adx': 11.498533705169242, 'trend_strength': 0.11498533705169242, 'volatility_ratio': 0.0014112598380760452, 'bb_width': 0.004162687401954372, 'prediction_confidence': 0.6, 'prediction_stability': 0.6, 'market_score': 5, 'raw_prediction': 3.8776747517314834e-07, 'scaled_prediction': 0.00019388373758657417}",80.8,136,506.8883664688417
2025-06-10 09:15:00,2025-06-10 09:30:00,BUY,3325.78,3329.04,0.01,32.6,take_profit,1,"{'rsi_14': 53.278239841407064, 'adx': 11.498533705169242, 'trend_strength': 0.11498533705169242, 'volatility_ratio': 0.0014112598380760452, 'bb_width': 0.004162687401954372, 'prediction_confidence': 0.6, 'prediction_stability': 0.6, 'market_score': 5, 'raw_prediction': 2.2166823330632305e-07, 'scaled_prediction': 0.00011083411665316153}",65.2,137,539.4883664688417
2025-06-10 10:00:00,2025-06-10 11:00:00,BUY,3328.16,3331.96,0.01,38.0,take_profit,7,"{'rsi_14': 53.278239841407064, 'adx': 11.498533705169242, 'trend_strength': 0.11498533705169242, 'volatility_ratio': 0.0014112598380760452, 'bb_width': 0.004162687401954372, 'prediction_confidence': 0.6, 'prediction_stability': 0.6, 'market_score': 5, 'raw_prediction': 2.0635222614605023e-07, 'scaled_prediction': 0.00010317611307302512}",76.0,138,577.4883664688417
2025-06-10 11:15:00,2025-06-10 11:30:00,BUY,3329.27,3327.57,0.01,-17.0,stop_loss,1,"{'rsi_14': 53.278239841407064, 'adx': 11.498533705169242, 'trend_strength': 0.11498533705169242, 'volatility_ratio': 0.0014112598380760452, 'bb_width': 0.004162687401954372, 'prediction_confidence': 0.6, 'prediction_stability': 0.6, 'market_score': 5, 'raw_prediction': 2.3395006420705603e-07, 'scaled_prediction': 0.00011697503210352802}",-34.0,139,560.4883664688417
2025-06-10 11:45:00,2025-06-10 12:30:00,BUY,3329.3,3327.76,0.01,-15.4,stop_loss,5,"{'rsi_14': 53.278239841407064, 'adx': 11.498533705169242, 'trend_strength': 0.11498533705169242, 'volatility_ratio': 0.0014112598380760452, 'bb_width': 0.004162687401954372, 'prediction_confidence': 0.6, 'prediction_stability': 0.6, 'market_score': 5, 'raw_prediction': 2.9141621787793693e-07, 'scaled_prediction': 0.00014570810893896848}",-30.8,140,545.0883664688417
2025-06-10 13:00:00,2025-06-10 13:15:00,BUY,3328.86,3333.85,0.01,49.9,take_profit,1,"{'rsi_14': 53.278239841407064, 'adx': 11.498533705169242, 'trend_strength': 0.11498533705169242, 'volatility_ratio': 0.0014112598380760452, 'bb_width': 0.004162687401954372, 'prediction_confidence': 0.6, 'prediction_stability': 0.6, 'market_score': 5, 'raw_prediction': 1.2345316636450166e-07, 'scaled_prediction': 6.172658318225083e-05}",99.8,141,594.9883664688417
2025-06-10 15:15:00,2025-06-10 16:15:00,BUY,3337.13,3345.6,0.01,84.7,take_profit,7,"{'rsi_14': 53.278239841407064, 'adx': 11.498533705169242, 'trend_strength': 0.11498533705169242, 'volatility_ratio': 0.0014112598380760452, 'bb_width': 0.004162687401954372, 'prediction_confidence': 0.6, 'prediction_stability': 0.6, 'market_score': 5, 'raw_prediction': 1.2639159102189737e-07, 'scaled_prediction': 6.319579551094868e-05}",169.4,142,679.6883664688418
2025-06-10 16:30:00,2025-06-10 16:45:00,BUY,3347.41,3343.68,0.01,-37.3,stop_loss,1,"{'rsi_14': 53.278239841407064, 'adx': 11.498533705169242, 'trend_strength': 0.11498533705169242, 'volatility_ratio': 0.0014112598380760452, 'bb_width': 0.004162687401954372, 'prediction_confidence': 0.6, 'prediction_stability': 0.6, 'market_score': 5, 'raw_prediction': 3.542730702140605e-07, 'scaled_prediction': 0.00017713653510703024}",-74.6,143,642.3883664688418
2025-06-10 17:00:00,2025-06-10 17:15:00,BUY,3336.0,3333.47,0.01,-25.3,stop_loss,1,"{'rsi_14': 53.278239841407064, 'adx': 11.498533705169242, 'trend_strength': 0.11498533705169242, 'volatility_ratio': 0.0014112598380760452, 'bb_width': 0.004162687401954372, 'prediction_confidence': 0.6, 'prediction_stability': 0.6, 'market_score': 5, 'raw_prediction': 1.8280340025617722e-07, 'scaled_prediction': 9.140170012808862e-05}",-50.6,144,617.0883664688419
2025-06-10 17:30:00,2025-06-10 17:45:00,BUY,3329.77,3328.57,0.01,-12.0,stop_loss,1,"{'rsi_14': 53.278239841407064, 'adx': 11.498533705169242, 'trend_strength': 0.11498533705169242, 'volatility_ratio': 0.0014112598380760452, 'bb_width': 0.004162687401954372, 'prediction_confidence': 0.6, 'prediction_stability': 0.6, 'market_score': 5, 'raw_prediction': 2.462429984332614e-07, 'scaled_prediction': 0.0001231214992166307}",-24.0,145,605.0883664688419
2025-06-10 18:00:00,2025-06-10 19:00:00,BUY,3325.88,3322.65,0.01,-32.3,stop_loss,7,"{'rsi_14': 53.278239841407064, 'adx': 11.498533705169242, 'trend_strength': 0.11498533705169242, 'volatility_ratio': 0.0014112598380760452, 'bb_width': 0.004162687401954372, 'prediction_confidence': 0.6, 'prediction_stability': 0.6, 'market_score': 5, 'raw_prediction': 1.4873540196784013e-07, 'scaled_prediction': 7.436770098392007e-05}",-64.6,146,572.7883664688419
2025-06-10 19:15:00,2025-06-10 19:45:00,BUY,3322.55,3321.39,0.01,-11.6,stop_loss,3,"{'rsi_14': 53.278239841407064, 'adx': 11.498533705169242, 'trend_strength': 0.11498533705169242, 'volatility_ratio': 0.0014112598380760452, 'bb_width': 0.004162687401954372, 'prediction_confidence': 0.6, 'prediction_stability': 0.6, 'market_score': 5, 'raw_prediction': 3.1199175281615016e-07, 'scaled_prediction': 0.00015599587640807507}",-23.2,147,561.1883664688419
2025-06-10 20:00:00,2025-06-10 22:00:00,BUY,3322.52,3325.88,0.01,33.6,take_profit,15,"{'rsi_14': 53.278239841407064, 'adx': 11.498533705169242, 'trend_strength': 0.11498533705169242, 'volatility_ratio': 0.0014112598380760452, 'bb_width': 0.004162687401954372, 'prediction_confidence': 0.6, 'prediction_stability': 0.6, 'market_score': 5, 'raw_prediction': 6.725994754858827e-07, 'scaled_prediction': 0.00033629973774294136}",67.2,148,594.7883664688419
2025-06-10 23:30:00,2025-06-10 23:45:00,BUY,3323.47,3322.38,0.01,-10.9,stop_loss,1,"{'rsi_14': 53.278239841407064, 'adx': 11.498533705169242, 'trend_strength': 0.11498533705169242, 'volatility_ratio': 0.0014112598380760452, 'bb_width': 0.004162687401954372, 'prediction_confidence': 0.6, 'prediction_stability': 0.6, 'market_score': 5, 'raw_prediction': 4.397366138107915e-07, 'scaled_prediction': 0.00021986830690539575}",-21.8,149,583.8883664688419
2025-06-11 01:00:00,2025-06-11 01:30:00,BUY,3321.91,3326.95,0.01,50.4,take_profit,3,"{'rsi_14': 53.278239841407064, 'adx': 11.498533705169242, 'trend_strength': 0.11498533705169242, 'volatility_ratio': 0.0014112598380760452, 'bb_width': 0.004162687401954372, 'prediction_confidence': 0.6, 'prediction_stability': 0.6, 'market_score': 5, 'raw_prediction': 6.14625983873009e-07, 'scaled_prediction': 0.0003073129919365045}",100.8,150,634.2883664688419
2025-06-11 01:45:00,2025-06-11 02:15:00,BUY,3324.4,3321.88,0.01,-25.2,stop_loss,3,"{'rsi_14': 53.278239841407064, 'adx': 11.498533705169242, 'trend_strength': 0.11498533705169242, 'volatility_ratio': 0.0014112598380760452, 'bb_width': 0.004162687401954372, 'prediction_confidence': 0.6, 'prediction_stability': 0.6, 'market_score': 5, 'raw_prediction': 5.898797534486121e-07, 'scaled_prediction': 0.0002949398767243061}",-50.4,151,609.0883664688419
2025-06-11 02:30:00,2025-06-11 03:00:00,BUY,3325.3,3328.1,0.01,28.0,take_profit,3,"{'rsi_14': 53.278239841407064, 'adx': 11.498533705169242, 'trend_strength': 0.11498533705169242, 'volatility_ratio': 0.0014112598380760452, 'bb_width': 0.004162687401954372, 'prediction_confidence': 0.6, 'prediction_stability': 0.6, 'market_score': 5, 'raw_prediction': 5.627896753036955e-07, 'scaled_prediction': 0.00028139483765184776}",56.0,152,637.0883664688419
2025-06-11 03:15:00,2025-06-11 04:00:00,BUY,3330.98,3333.79,0.01,28.1,take_profit,5,"{'rsi_14': 53.278239841407064, 'adx': 11.498533705169242, 'trend_strength': 0.11498533705169242, 'volatility_ratio': 0.0014112598380760452, 'bb_width': 0.004162687401954372, 'prediction_confidence': 0.6, 'prediction_stability': 0.6, 'market_score': 5, 'raw_prediction': 8.240989696952332e-08, 'scaled_prediction': 4.120494848476166e-05}",56.2,153,665.1883664688419
2025-06-11 04:15:00,2025-06-11 04:30:00,BUY,3335.54,3334.53,0.01,-10.1,stop_loss,1,"{'rsi_14': 53.278239841407064, 'adx': 11.498533705169242, 'trend_strength': 0.11498533705169242, 'volatility_ratio': 0.0014112598380760452, 'bb_width': 0.004162687401954372, 'prediction_confidence': 0.6, 'prediction_stability': 0.6, 'market_score': 5, 'raw_prediction': 4.0839746361860133e-07, 'scaled_prediction': 0.00020419873180930066}",-20.2,154,655.0883664688419
2025-06-11 04:45:00,2025-06-11 05:00:00,BUY,3328.72,3332.03,0.01,33.1,take_profit,1,"{'rsi_14': 53.278239841407064, 'adx': 11.498533705169242, 'trend_strength': 0.11498533705169242, 'volatility_ratio': 0.0014112598380760452, 'bb_width': 0.004162687401954372, 'prediction_confidence': 0.6, 'prediction_stability': 0.6, 'market_score': 5, 'raw_prediction': 3.9384496642401426e-07, 'scaled_prediction': 0.00019692248321200712}",66.2,155,688.1883664688419
2025-06-11 05:15:00,2025-06-11 05:30:00,BUY,3333.35,3336.87,0.01,35.2,take_profit,1,"{'rsi_14': 53.278239841407064, 'adx': 11.498533705169242, 'trend_strength': 0.11498533705169242, 'volatility_ratio': 0.0014112598380760452, 'bb_width': 0.004162687401954372, 'prediction_confidence': 0.6, 'prediction_stability': 0.6, 'market_score': 5, 'raw_prediction': 6.185210077954249e-07, 'scaled_prediction': 0.00030926050389771246}",70.4,156,723.3883664688419
2025-06-11 05:45:00,2025-06-11 06:00:00,BUY,3337.99,3336.92,0.01,-10.7,stop_loss,1,"{'rsi_14': 53.278239841407064, 'adx': 11.498533705169242, 'trend_strength': 0.11498533705169242, 'volatility_ratio': 0.0014112598380760452, 'bb_width': 0.004162687401954372, 'prediction_confidence': 0.6, 'prediction_stability': 0.6, 'market_score': 5, 'raw_prediction': 6.936856661995597e-07, 'scaled_prediction': 0.00034684283309977985}",-21.4,157,712.6883664688419
2025-06-11 06:15:00,2025-06-11 07:00:00,BUY,3339.25,3342.47,0.01,32.2,take_profit,5,"{'rsi_14': 53.278239841407064, 'adx': 11.498533705169242, 'trend_strength': 0.11498533705169242, 'volatility_ratio': 0.0014112598380760452, 'bb_width': 0.004162687401954372, 'prediction_confidence': 0.6, 'prediction_stability': 0.6, 'market_score': 5, 'raw_prediction': 2.3495290953685286e-07, 'scaled_prediction': 0.00011747645476842643}",64.4,158,744.8883664688419
2025-06-11 07:15:00,2025-06-11 08:00:00,BUY,3341.82,3340.56,0.01,-12.6,stop_loss,5,"{'rsi_14': 53.278239841407064, 'adx': 11.498533705169242, 'trend_strength': 0.11498533705169242, 'volatility_ratio': 0.0014112598380760452, 'bb_width': 0.004162687401954372, 'prediction_confidence': 0.6, 'prediction_stability': 0.6, 'market_score': 5, 'raw_prediction': 8.159138103895492e-08, 'scaled_prediction': 4.0795690519477465e-05}",-25.2,159,732.2883664688419
2025-06-11 13:00:00,2025-06-11 13:15:00,BUY,3334.41,3331.98,0.01,-24.3,stop_loss,1,"{'rsi_14': 53.278239841407064, 'adx': 11.498533705169242, 'trend_strength': 0.11498533705169242, 'volatility_ratio': 0.0014112598380760452, 'bb_width': 0.004162687401954372, 'prediction_confidence': 0.6, 'prediction_stability': 0.6, 'market_score': 5, 'raw_prediction': 8.800123768372787e-08, 'scaled_prediction': 4.4000618841863935e-05}",-48.6,160,707.988366468842
2025-06-11 13:30:00,2025-06-11 13:45:00,BUY,3331.31,3329.98,0.01,-13.3,stop_loss,1,"{'rsi_14': 53.278239841407064, 'adx': 11.498533705169242, 'trend_strength': 0.11498533705169242, 'volatility_ratio': 0.0014112598380760452, 'bb_width': 0.004162687401954372, 'prediction_confidence': 0.6, 'prediction_stability': 0.6, 'market_score': 5, 'raw_prediction': 1.896784669349652e-07, 'scaled_prediction': 9.48392334674826e-05}",-26.6,161,694.688366468842
2025-06-11 14:00:00,2025-06-11 14:30:00,BUY,3329.73,3334.54,0.01,48.1,take_profit,3,"{'rsi_14': 53.278239841407064, 'adx': 11.498533705169242, 'trend_strength': 0.11498533705169242, 'volatility_ratio': 0.0014112598380760452, 'bb_width': 0.004162687401954372, 'prediction_confidence': 0.6, 'prediction_stability': 0.6, 'market_score': 5, 'raw_prediction': 1.789832457569334e-07, 'scaled_prediction': 8.949162287846669e-05}",96.2,162,742.788366468842
2025-06-11 14:45:00,2025-06-11 15:15:00,BUY,3332.86,3339.71,0.01,68.5,take_profit,3,"{'rsi_14': 53.278239841407064, 'adx': 11.498533705169242, 'trend_strength': 0.11498533705169242, 'volatility_ratio': 0.0014112598380760452, 'bb_width': 0.004162687401954372, 'prediction_confidence': 0.6, 'prediction_stability': 0.6, 'market_score': 5, 'raw_prediction': 3.398770640408817e-07, 'scaled_prediction': 0.00016993853202044087}",137.0,163,811.288366468842
2025-06-11 15:30:00,2025-06-11 15:45:00,BUY,3354.39,3336.89,0.01,-97.35460397626103,daily_loss_limit,1,"{'rsi_14': 53.278239841407064, 'adx': 11.498533705169242, 'trend_strength': 0.11498533705169242, 'volatility_ratio': 0.0014112598380760452, 'bb_width': 0.004162687401954372, 'prediction_confidence': 0.6, 'prediction_stability': 0.6, 'market_score': 5, 'raw_prediction': 2.9084880949070583e-07, 'scaled_prediction': 0.0001454244047453529}",-272.35460397626105,164,713.933762492581
2025-06-11 15:45:00,2025-06-11 16:00:00,BUY,3336.89,3341.6,0.01,47.1,take_profit,1,"{'rsi_14': 53.278239841407064, 'adx': 11.498533705169242, 'trend_strength': 0.11498533705169242, 'volatility_ratio': 0.0014112598380760452, 'bb_width': 0.004162687401954372, 'prediction_confidence': 0.6, 'prediction_stability': 0.6, 'market_score': 5, 'raw_prediction': 4.3439955434741956e-08, 'scaled_prediction': 2.171997771737098e-05}",94.2,165,761.033762492581
2025-06-11 18:00:00,2025-06-11 18:15:00,BUY,3340.82,3339.74,0.01,-10.8,stop_loss,1,"{'rsi_14': 53.278239841407064, 'adx': 11.498533705169242, 'trend_strength': 0.11498533705169242, 'volatility_ratio': 0.0014112598380760452, 'bb_width': 0.004162687401954372, 'prediction_confidence': 0.6, 'prediction_stability': 0.6, 'market_score': 5, 'raw_prediction': 3.2325246142069937e-07, 'scaled_prediction': 0.0001616262307103497}",-21.6,166,750.233762492581
2025-06-11 18:30:00,2025-06-11 18:45:00,BUY,3335.18,3332.96,0.01,-22.2,stop_loss,1,"{'rsi_14': 53.278239841407064, 'adx': 11.498533705169242, 'trend_strength': 0.11498533705169242, 'volatility_ratio': 0.0014112598380760452, 'bb_width': 0.004162687401954372, 'prediction_confidence': 0.6, 'prediction_stability': 0.6, 'market_score': 5, 'raw_prediction': 1.808462693251536e-07, 'scaled_prediction': 9.042313466257681e-05}",-44.4,167,728.033762492581
2025-06-11 19:00:00,2025-06-11 20:00:00,BUY,3329.87,3327.13,0.01,-27.4,stop_loss,7,"{'rsi_14': 53.278239841407064, 'adx': 11.498533705169242, 'trend_strength': 0.11498533705169242, 'volatility_ratio': 0.0014112598380760452, 'bb_width': 0.004162687401954372, 'prediction_confidence': 0.6, 'prediction_stability': 0.6, 'market_score': 5, 'raw_prediction': 2.4408022007505305e-07, 'scaled_prediction': 0.00012204011003752653}",-54.8,168,700.633762492581
2025-06-11 20:15:00,2025-06-11 20:30:00,BUY,3323.63,3322.24,0.01,-13.9,stop_loss,1,"{'rsi_14': 53.278239841407064, 'adx': 11.498533705169242, 'trend_strength': 0.11498533705169242, 'volatility_ratio': 0.0014112598380760452, 'bb_width': 0.004162687401954372, 'prediction_confidence': 0.6, 'prediction_stability': 0.6, 'market_score': 5, 'raw_prediction': 2.282118511455543e-07, 'scaled_prediction': 0.00011410592557277715}",-27.8,169,686.733762492581
2025-06-11 20:45:00,2025-06-11 21:00:00,BUY,3324.07,3341.8,0.01,177.3,take_profit,1,"{'rsi_14': 53.278239841407064, 'adx': 11.498533705169242, 'trend_strength': 0.11498533705169242, 'volatility_ratio': 0.0014112598380760452, 'bb_width': 0.004162687401954372, 'prediction_confidence': 0.6, 'prediction_stability': 0.6, 'market_score': 5, 'raw_prediction': 2.2839156737279187e-07, 'scaled_prediction': 0.00011419578368639593}",354.6,170,864.033762492581
2025-06-11 21:15:00,2025-06-11 21:30:00,BUY,3345.55,3341.13,0.01,-44.2,stop_loss,1,"{'rsi_14': 53.278239841407064, 'adx': 11.498533705169242, 'trend_strength': 0.11498533705169242, 'volatility_ratio': 0.0014112598380760452, 'bb_width': 0.004162687401954372, 'prediction_confidence': 0.6, 'prediction_stability': 0.6, 'market_score': 5, 'raw_prediction': 2.2742625163408942e-07, 'scaled_prediction': 0.0001137131258170447}",-88.4,171,819.833762492581
2025-06-11 21:45:00,2025-06-11 22:30:00,BUY,3343.63,3348.12,0.01,44.9,take_profit,5,"{'rsi_14': 53.278239841407064, 'adx': 11.498533705169242, 'trend_strength': 0.11498533705169242, 'volatility_ratio': 0.0014112598380760452, 'bb_width': 0.004162687401954372, 'prediction_confidence': 0.6, 'prediction_stability': 0.6, 'market_score': 5, 'raw_prediction': 2.2942306515720966e-07, 'scaled_prediction': 0.00011471153257860483}",89.8,172,864.7337624925809
2025-06-11 23:00:00,2025-06-11 23:15:00,BUY,3348.25,3352.33,0.01,40.8,take_profit,1,"{'rsi_14': 53.278239841407064, 'adx': 11.498533705169242, 'trend_strength': 0.11498533705169242, 'volatility_ratio': 0.0014112598380760452, 'bb_width': 0.004162687401954372, 'prediction_confidence': 0.6, 'prediction_stability': 0.6, 'market_score': 5, 'raw_prediction': 2.466764707385264e-07, 'scaled_prediction': 0.0001233382353692632}",81.6,173,905.5337624925809
2025-06-11 23:30:00,2025-06-11 23:45:00,BUY,3351.95,3354.74,0.01,27.9,take_profit,1,"{'rsi_14': 53.278239841407064, 'adx': 11.498533705169242, 'trend_strength': 0.11498533705169242, 'volatility_ratio': 0.0014112598380760452, 'bb_width': 0.004162687401954372, 'prediction_confidence': 0.6, 'prediction_stability': 0.6, 'market_score': 5, 'raw_prediction': 1.7218307757719704e-07, 'scaled_prediction': 8.609153878859852e-05}",55.8,174,933.4337624925809
2025-06-12 02:00:00,2025-06-12 02:15:00,BUY,3366.65,3364.61,0.01,-20.4,stop_loss,1,"{'rsi_14': 53.278239841407064, 'adx': 11.498533705169242, 'trend_strength': 0.11498533705169242, 'volatility_ratio': 0.0014112598380760452, 'bb_width': 0.004162687401954372, 'prediction_confidence': 0.6, 'prediction_stability': 0.6, 'market_score': 5, 'raw_prediction': 7.353692497662767e-08, 'scaled_prediction': 3.676846248831384e-05}",-40.8,175,913.0337624925809
2025-06-12 02:30:00,2025-06-12 04:15:00,BUY,3365.53,3375.25,0.01,97.2,take_profit,13,"{'rsi_14': 53.278239841407064, 'adx': 11.498533705169242, 'trend_strength': 0.11498533705169242, 'volatility_ratio': 0.0014112598380760452, 'bb_width': 0.004162687401954372, 'prediction_confidence': 0.6, 'prediction_stability': 0.6, 'market_score': 5, 'raw_prediction': 4.133924957583556e-07, 'scaled_prediction': 0.0002066962478791778}",194.4,176,1010.2337624925809
2025-06-12 04:30:00,2025-06-12 05:00:00,BUY,3368.77,3371.93,0.01,31.6,take_profit,3,"{'rsi_14': 53.278239841407064, 'adx': 11.498533705169242, 'trend_strength': 0.11498533705169242, 'volatility_ratio': 0.0014112598380760452, 'bb_width': 0.004162687401954372, 'prediction_confidence': 0.6, 'prediction_stability': 0.6, 'market_score': 5, 'raw_prediction': 4.857525056152439e-07, 'scaled_prediction': 0.00024287625280762195}",63.2,177,1041.833762492581
2025-06-12 05:15:00,2025-06-12 05:30:00,BUY,3374.01,3376.96,0.01,29.5,take_profit,1,"{'rsi_14': 53.278239841407064, 'adx': 11.498533705169242, 'trend_strength': 0.11498533705169242, 'volatility_ratio': 0.0014112598380760452, 'bb_width': 0.004162687401954372, 'prediction_confidence': 0.6, 'prediction_stability': 0.6, 'market_score': 5, 'raw_prediction': 2.2182252723279416e-07, 'scaled_prediction': 0.00011091126361639709}",59.0,178,1071.333762492581
2025-06-12 05:45:00,2025-06-12 06:45:00,BUY,3374.46,3373.14,0.01,-13.2,stop_loss,7,"{'rsi_14': 53.278239841407064, 'adx': 11.498533705169242, 'trend_strength': 0.11498533705169242, 'volatility_ratio': 0.0014112598380760452, 'bb_width': 0.004162687401954372, 'prediction_confidence': 0.6, 'prediction_stability': 0.6, 'market_score': 5, 'raw_prediction': 2.854978373117876e-07, 'scaled_prediction': 0.00014274891865589378}",-26.4,179,1058.133762492581
2025-06-12 07:00:00,2025-06-12 07:30:00,BUY,3370.19,3373.25,0.01,30.6,take_profit,3,"{'rsi_14': 53.278239841407064, 'adx': 11.498533705169242, 'trend_strength': 0.11498533705169242, 'volatility_ratio': 0.0014112598380760452, 'bb_width': 0.004162687401954372, 'prediction_confidence': 0.6, 'prediction_stability': 0.6, 'market_score': 5, 'raw_prediction': 2.8572400333787303e-07, 'scaled_prediction': 0.00014286200166893653}",61.2,180,1088.7337624925808
2025-06-12 08:30:00,2025-06-12 09:00:00,BUY,3374.64,3371.17,0.01,-34.7,stop_loss,3,"{'rsi_14': 53.278239841407064, 'adx': 11.498533705169242, 'trend_strength': 0.11498533705169242, 'volatility_ratio': 0.0014112598380760452, 'bb_width': 0.004162687401954372, 'prediction_confidence': 0.6, 'prediction_stability': 0.6, 'market_score': 5, 'raw_prediction': 7.641628324040997e-08, 'scaled_prediction': 3.820814162020498e-05}",-69.4,181,1054.0337624925808
2025-06-12 09:15:00,2025-06-12 09:45:00,BUY,3369.43,3374.75,0.01,53.2,take_profit,3,"{'rsi_14': 53.278239841407064, 'adx': 11.498533705169242, 'trend_strength': 0.11498533705169242, 'volatility_ratio': 0.0014112598380760452, 'bb_width': 0.004162687401954372, 'prediction_confidence': 0.6, 'prediction_stability': 0.6, 'market_score': 5, 'raw_prediction': 8.912685743029444e-08, 'scaled_prediction': 4.4563428715147225e-05}",106.4,182,1107.2337624925808
2025-06-12 10:00:00,2025-06-12 10:15:00,BUY,3371.27,3370.01,0.01,-12.6,stop_loss,1,"{'rsi_14': 53.278239841407064, 'adx': 11.498533705169242, 'trend_strength': 0.11498533705169242, 'volatility_ratio': 0.0014112598380760452, 'bb_width': 0.004162687401954372, 'prediction_confidence': 0.6, 'prediction_stability': 0.6, 'market_score': 5, 'raw_prediction': 2.0206840419669584e-07, 'scaled_prediction': 0.00010103420209834791}",-25.2,183,1094.633762492581
2025-06-12 10:30:00,2025-06-12 10:45:00,BUY,3342.39,3345.91,0.01,35.2,take_profit,1,"{'rsi_14': 53.278239841407064, 'adx': 11.498533705169242, 'trend_strength': 0.11498533705169242, 'volatility_ratio': 0.0014112598380760452, 'bb_width': 0.004162687401954372, 'prediction_confidence': 0.6, 'prediction_stability': 0.6, 'market_score': 5, 'raw_prediction': 7.090678262602106e-08, 'scaled_prediction': 3.545339131301053e-05}",70.4,184,1129.833762492581
2025-06-12 11:00:00,2025-06-12 11:15:00,BUY,3350.39,3358.69,0.01,83.0,take_profit,1,"{'rsi_14': 53.278239841407064, 'adx': 11.498533705169242, 'trend_strength': 0.11498533705169242, 'volatility_ratio': 0.0014112598380760452, 'bb_width': 0.004162687401954372, 'prediction_confidence': 0.6, 'prediction_stability': 0.6, 'market_score': 5, 'raw_prediction': 6.06425310535855e-08, 'scaled_prediction': 3.0321265526792753e-05}",166.0,185,1212.833762492581
2025-06-12 11:30:00,2025-06-12 11:45:00,BUY,3358.38,3356.89,0.01,-14.9,stop_loss,1,"{'rsi_14': 53.278239841407064, 'adx': 11.498533705169242, 'trend_strength': 0.11498533705169242, 'volatility_ratio': 0.0014112598380760452, 'bb_width': 0.004162687401954372, 'prediction_confidence': 0.6, 'prediction_stability': 0.6, 'market_score': 5, 'raw_prediction': 2.5844122860912943e-07, 'scaled_prediction': 0.00012922061430456472}",-29.8,186,1197.9337624925809
2025-06-12 12:15:00,2025-06-12 12:45:00,BUY,3361.28,3365.15,0.01,38.7,take_profit,3,"{'rsi_14': 53.278239841407064, 'adx': 11.498533705169242, 'trend_strength': 0.11498533705169242, 'volatility_ratio': 0.0014112598380760452, 'bb_width': 0.004162687401954372, 'prediction_confidence': 0.6, 'prediction_stability': 0.6, 'market_score': 5, 'raw_prediction': 3.295904011759259e-08, 'scaled_prediction': 1.6479520058796296e-05}",77.4,187,1236.633762492581
2025-06-12 13:30:00,2025-06-12 14:00:00,BUY,3381.89,3385.3,0.01,34.1,take_profit,3,"{'rsi_14': 53.278239841407064, 'adx': 11.498533705169242, 'trend_strength': 0.11498533705169242, 'volatility_ratio': 0.0014112598380760452, 'bb_width': 0.004162687401954372, 'prediction_confidence': 0.6, 'prediction_stability': 0.6, 'market_score': 5, 'raw_prediction': 3.346678276077372e-07, 'scaled_prediction': 0.0001673339138038686}",68.2,188,1270.7337624925808
2025-06-12 14:15:00,2025-06-12 14:30:00,BUY,3380.9,3376.93,0.01,-39.7,stop_loss,1,"{'rsi_14': 53.278239841407064, 'adx': 11.498533705169242, 'trend_strength': 0.11498533705169242, 'volatility_ratio': 0.0014112598380760452, 'bb_width': 0.004162687401954372, 'prediction_confidence': 0.6, 'prediction_stability': 0.6, 'market_score': 5, 'raw_prediction': 1.071138978028249e-07, 'scaled_prediction': 5.355694890141245e-05}",-79.4,189,1231.0337624925808
2025-06-12 14:45:00,2025-06-12 15:15:00,BUY,3379.18,3382.79,0.01,36.1,take_profit,3,"{'rsi_14': 53.278239841407064, 'adx': 11.498533705169242, 'trend_strength': 0.11498533705169242, 'volatility_ratio': 0.0014112598380760452, 'bb_width': 0.004162687401954372, 'prediction_confidence': 0.6, 'prediction_stability': 0.6, 'market_score': 5, 'raw_prediction': 4.709798669468798e-07, 'scaled_prediction': 0.0002354899334734399}",72.2,190,1267.1337624925807
2025-06-12 15:30:00,2025-06-12 16:00:00,BUY,3388.15,3383.26,0.01,-48.9,stop_loss,3,"{'rsi_14': 53.278239841407064, 'adx': 11.498533705169242, 'trend_strength': 0.11498533705169242, 'volatility_ratio': 0.0014112598380760452, 'bb_width': 0.004162687401954372, 'prediction_confidence': 0.6, 'prediction_stability': 0.6, 'market_score': 5, 'raw_prediction': 3.8008426781829663e-07, 'scaled_prediction': 0.0001900421339091483}",-97.8,191,1218.2337624925806
2025-06-12 16:15:00,2025-06-12 16:30:00,BUY,3382.97,3398.07,0.01,151.0,take_profit,1,"{'rsi_14': 53.278239841407064, 'adx': 11.498533705169242, 'trend_strength': 0.11498533705169242, 'volatility_ratio': 0.0014112598380760452, 'bb_width': 0.004162687401954372, 'prediction_confidence': 0.6, 'prediction_stability': 0.6, 'market_score': 5, 'raw_prediction': 5.439506494144194e-07, 'scaled_prediction': 0.00027197532470720967}",302.0,192,1369.2337624925806
2025-06-12 16:45:00,2025-06-12 17:00:00,BUY,3391.84,3387.13,0.01,-47.1,stop_loss,1,"{'rsi_14': 53.278239841407064, 'adx': 11.498533705169242, 'trend_strength': 0.11498533705169242, 'volatility_ratio': 0.0014112598380760452, 'bb_width': 0.004162687401954372, 'prediction_confidence': 0.6, 'prediction_stability': 0.6, 'market_score': 5, 'raw_prediction': 7.033192086181012e-07, 'scaled_prediction': 0.0003516596043090506}",-94.2,193,1322.1337624925807
2025-06-12 17:15:00,2025-06-12 17:30:00,BUY,3388.97,3387.84,0.01,-11.3,stop_loss,1,"{'rsi_14': 53.278239841407064, 'adx': 11.498533705169242, 'trend_strength': 0.11498533705169242, 'volatility_ratio': 0.0014112598380760452, 'bb_width': 0.004162687401954372, 'prediction_confidence': 0.6, 'prediction_stability': 0.6, 'market_score': 5, 'raw_prediction': 3.350008337967393e-07, 'scaled_prediction': 0.00016750041689836965}",-22.6,194,1310.8337624925807
2025-06-12 17:45:00,2025-06-12 18:00:00,BUY,3383.94,3380.15,0.01,-37.9,stop_loss,1,"{'rsi_14': 53.278239841407064, 'adx': 11.498533705169242, 'trend_strength': 0.11498533705169242, 'volatility_ratio': 0.0014112598380760452, 'bb_width': 0.004162687401954372, 'prediction_confidence': 0.6, 'prediction_stability': 0.6, 'market_score': 5, 'raw_prediction': 2.792583252972128e-07, 'scaled_prediction': 0.0001396291626486064}",-75.8,195,1272.9337624925806
2025-06-12 18:15:00,2025-06-12 18:45:00,BUY,3388.14,3385.89,0.01,-22.5,stop_loss,3,"{'rsi_14': 53.278239841407064, 'adx': 11.498533705169242, 'trend_strength': 0.11498533705169242, 'volatility_ratio': 0.0014112598380760452, 'bb_width': 0.004162687401954372, 'prediction_confidence': 0.6, 'prediction_stability': 0.6, 'market_score': 5, 'raw_prediction': 4.3021704177837776e-07, 'scaled_prediction': 0.0002151085208891889}",-45.0,196,1250.4337624925806
2025-06-12 19:00:00,2025-06-12 19:15:00,BUY,3386.49,3389.04,0.01,25.5,take_profit,1,"{'rsi_14': 53.278239841407064, 'adx': 11.498533705169242, 'trend_strength': 0.11498533705169242, 'volatility_ratio': 0.0014112598380760452, 'bb_width': 0.004162687401954372, 'prediction_confidence': 0.6, 'prediction_stability': 0.6, 'market_score': 5, 'raw_prediction': 4.072004812986163e-07, 'scaled_prediction': 0.00020360024064930817}",51.0,197,1275.9337624925806
2025-06-12 19:30:00,2025-06-12 19:45:00,BUY,3388.38,3383.81,0.01,-45.7,stop_loss,1,"{'rsi_14': 53.278239841407064, 'adx': 11.498533705169242, 'trend_strength': 0.11498533705169242, 'volatility_ratio': 0.0014112598380760452, 'bb_width': 0.004162687401954372, 'prediction_confidence': 0.6, 'prediction_stability': 0.6, 'market_score': 5, 'raw_prediction': 6.400003331128205e-07, 'scaled_prediction': 0.00032000016655641024}",-91.4,198,1230.2337624925806
2025-06-12 20:00:00,2025-06-12 21:00:00,BUY,3381.33,3384.15,0.01,28.2,take_profit,7,"{'rsi_14': 53.278239841407064, 'adx': 11.498533705169242, 'trend_strength': 0.11498533705169242, 'volatility_ratio': 0.0014112598380760452, 'bb_width': 0.004162687401954372, 'prediction_confidence': 0.6, 'prediction_stability': 0.6, 'market_score': 5, 'raw_prediction': 7.462826323511739e-07, 'scaled_prediction': 0.0003731413161755869}",56.4,199,1258.4337624925806
2025-06-12 21:15:00,2025-06-12 21:45:00,BUY,3383.11,3386.04,0.01,29.3,take_profit,3,"{'rsi_14': 53.278239841407064, 'adx': 11.498533705169242, 'trend_strength': 0.11498533705169242, 'volatility_ratio': 0.0014112598380760452, 'bb_width': 0.004162687401954372, 'prediction_confidence': 0.6, 'prediction_stability': 0.6, 'market_score': 5, 'raw_prediction': 6.882166490209101e-07, 'scaled_prediction': 0.00034410832451045505}",58.6,200,1287.7337624925806
2025-06-12 22:00:00,2025-06-12 23:00:00,BUY,3386.2,3388.76,0.01,25.6,take_profit,7,"{'rsi_14': 53.278239841407064, 'adx': 11.498533705169242, 'trend_strength': 0.11498533705169242, 'volatility_ratio': 0.0014112598380760452, 'bb_width': 0.004162687401954372, 'prediction_confidence': 0.6, 'prediction_stability': 0.6, 'market_score': 5, 'raw_prediction': 2.1586650107944576e-07, 'scaled_prediction': 0.00010793325053972288}",51.2,201,1313.3337624925805
2025-06-12 23:30:00,2025-06-13 01:00:00,BUY,3385.91,3382.61,0.01,-33.0,stop_loss,3,"{'rsi_14': 53.278239841407064, 'adx': 11.498533705169242, 'trend_strength': 0.11498533705169242, 'volatility_ratio': 0.0014112598380760452, 'bb_width': 0.004162687401954372, 'prediction_confidence': 0.6, 'prediction_stability': 0.6, 'market_score': 5, 'raw_prediction': 8.827885911267322e-08, 'scaled_prediction': 4.413942955633661e-05}",-66.0,202,1280.3337624925805
2025-06-13 01:15:00,2025-06-13 02:30:00,BUY,3382.63,3387.36,0.01,47.3,take_profit,9,"{'rsi_14': 53.278239841407064, 'adx': 11.498533705169242, 'trend_strength': 0.11498533705169242, 'volatility_ratio': 0.0014112598380760452, 'bb_width': 0.004162687401954372, 'prediction_confidence': 0.6, 'prediction_stability': 0.6, 'market_score': 5, 'raw_prediction': 1.7312871940175212e-07, 'scaled_prediction': 8.656435970087607e-05}",94.6,203,1327.6337624925804
2025-06-13 03:00:00,2025-06-13 03:15:00,BUY,3402.14,3413.95,0.01,118.1,take_profit,1,"{'rsi_14': 53.278239841407064, 'adx': 11.498533705169242, 'trend_strength': 0.11498533705169242, 'volatility_ratio': 0.0014112598380760452, 'bb_width': 0.004162687401954372, 'prediction_confidence': 0.6, 'prediction_stability': 0.6, 'market_score': 5, 'raw_prediction': 3.550823019512097e-08, 'scaled_prediction': 1.7754115097560487e-05}",236.2,204,1445.7337624925804
2025-06-13 03:30:00,2025-06-13 03:45:00,BUY,3406.52,3416.62,0.01,101.0,take_profit,1,"{'rsi_14': 53.278239841407064, 'adx': 11.498533705169242, 'trend_strength': 0.11498533705169242, 'volatility_ratio': 0.0014112598380760452, 'bb_width': 0.004162687401954372, 'prediction_confidence': 0.6, 'prediction_stability': 0.6, 'market_score': 5, 'raw_prediction': 1.0295417455793606e-07, 'scaled_prediction': 5.1477087278968024e-05}",202.0,205,1546.7337624925804
2025-06-13 04:00:00,2025-06-13 04:15:00,BUY,3425.67,3429.5,0.01,38.3,take_profit,1,"{'rsi_14': 53.278239841407064, 'adx': 11.498533705169242, 'trend_strength': 0.11498533705169242, 'volatility_ratio': 0.0014112598380760452, 'bb_width': 0.004162687401954372, 'prediction_confidence': 0.6, 'prediction_stability': 0.6, 'market_score': 5, 'raw_prediction': 2.5185602143571745e-07, 'scaled_prediction': 0.00012592801071785873}",76.6,206,1585.0337624925803
2025-06-13 04:30:00,2025-06-13 04:45:00,BUY,3429.98,3427.32,0.01,-26.6,stop_loss,1,"{'rsi_14': 53.278239841407064, 'adx': 11.498533705169242, 'trend_strength': 0.11498533705169242, 'volatility_ratio': 0.0014112598380760452, 'bb_width': 0.004162687401954372, 'prediction_confidence': 0.6, 'prediction_stability': 0.6, 'market_score': 5, 'raw_prediction': 1.6819270978493096e-07, 'scaled_prediction': 8.409635489246547e-05}",-53.2,207,1558.4337624925804
2025-06-13 05:00:00,2025-06-13 05:15:00,BUY,3429.61,3433.09,0.01,34.8,take_profit,1,"{'rsi_14': 53.278239841407064, 'adx': 11.498533705169242, 'trend_strength': 0.11498533705169242, 'volatility_ratio': 0.0014112598380760452, 'bb_width': 0.004162687401954372, 'prediction_confidence': 0.6, 'prediction_stability': 0.6, 'market_score': 5, 'raw_prediction': 1.132933393405987e-07, 'scaled_prediction': 5.664666967029935e-05}",69.6,208,1593.2337624925804
2025-06-13 05:30:00,2025-06-13 05:45:00,BUY,3437.81,3441.48,0.01,36.7,take_profit,1,"{'rsi_14': 53.278239841407064, 'adx': 11.498533705169242, 'trend_strength': 0.11498533705169242, 'volatility_ratio': 0.0014112598380760452, 'bb_width': 0.004162687401954372, 'prediction_confidence': 0.6, 'prediction_stability': 0.6, 'market_score': 5, 'raw_prediction': 2.9065934350321183e-07, 'scaled_prediction': 0.00014532967175160592}",73.4,209,1629.9337624925804
2025-06-13 06:00:00,2025-06-13 06:15:00,BUY,3431.75,3430.66,0.01,-10.9,stop_loss,1,"{'rsi_14': 53.278239841407064, 'adx': 11.498533705169242, 'trend_strength': 0.11498533705169242, 'volatility_ratio': 0.0014112598380760452, 'bb_width': 0.004162687401954372, 'prediction_confidence': 0.6, 'prediction_stability': 0.6, 'market_score': 5, 'raw_prediction': 3.358863178355939e-07, 'scaled_prediction': 0.00016794315891779693}",-21.8,210,1619.0337624925803
2025-06-13 06:30:00,2025-06-13 06:45:00,BUY,3430.05,3425.72,0.01,-43.3,stop_loss,1,"{'rsi_14': 53.278239841407064, 'adx': 11.498533705169242, 'trend_strength': 0.11498533705169242, 'volatility_ratio': 0.0014112598380760452, 'bb_width': 0.004162687401954372, 'prediction_confidence': 0.6, 'prediction_stability': 0.6, 'market_score': 5, 'raw_prediction': 3.7727988090616627e-07, 'scaled_prediction': 0.00018863994045308313}",-86.6,211,1575.7337624925804
2025-06-13 07:00:00,2025-06-13 07:45:00,BUY,3427.94,3425.33,0.01,-26.1,stop_loss,5,"{'rsi_14': 53.278239841407064, 'adx': 11.498533705169242, 'trend_strength': 0.11498533705169242, 'volatility_ratio': 0.0014112598380760452, 'bb_width': 0.004162687401954372, 'prediction_confidence': 0.6, 'prediction_stability': 0.6, 'market_score': 5, 'raw_prediction': 5.950131162297674e-08, 'scaled_prediction': 2.9750655811488368e-05}",-52.2,212,1549.6337624925804
2025-06-13 08:30:00,2025-06-13 09:00:00,BUY,3423.59,3422.35,0.01,-12.4,stop_loss,3,"{'rsi_14': 53.278239841407064, 'adx': 11.498533705169242, 'trend_strength': 0.11498533705169242, 'volatility_ratio': 0.0014112598380760452, 'bb_width': 0.004162687401954372, 'prediction_confidence': 0.6, 'prediction_stability': 0.6, 'market_score': 5, 'raw_prediction': 1.0760774606165379e-07, 'scaled_prediction': 5.38038730308269e-05}",-24.8,213,1537.2337624925804
2025-06-13 10:00:00,2025-06-13 10:15:00,BUY,3412.86,3416.01,0.01,31.5,take_profit,1,"{'rsi_14': 53.278239841407064, 'adx': 11.498533705169242, 'trend_strength': 0.11498533705169242, 'volatility_ratio': 0.0014112598380760452, 'bb_width': 0.004162687401954372, 'prediction_confidence': 0.6, 'prediction_stability': 0.6, 'market_score': 5, 'raw_prediction': 5.9248050009787656e-08, 'scaled_prediction': 2.962402500489383e-05}",63.0,214,1568.7337624925804
2025-06-13 10:30:00,2025-06-13 10:45:00,BUY,3416.34,3414.99,0.01,-13.5,stop_loss,1,"{'rsi_14': 53.278239841407064, 'adx': 11.498533705169242, 'trend_strength': 0.11498533705169242, 'volatility_ratio': 0.0014112598380760452, 'bb_width': 0.004162687401954372, 'prediction_confidence': 0.6, 'prediction_stability': 0.6, 'market_score': 5, 'raw_prediction': 9.496830897547615e-08, 'scaled_prediction': 4.7484154487738074e-05}",-27.0,215,1555.2337624925804
2025-06-13 11:15:00,2025-06-13 12:15:00,BUY,3423.47,3422.1,0.01,-13.7,stop_loss,7,"{'rsi_14': 53.278239841407064, 'adx': 11.498533705169242, 'trend_strength': 0.11498533705169242, 'volatility_ratio': 0.0014112598380760452, 'bb_width': 0.004162687401954372, 'prediction_confidence': 0.6, 'prediction_stability': 0.6, 'market_score': 5, 'raw_prediction': 1.3013748675610387e-07, 'scaled_prediction': 6.506874337805194e-05}",-27.4,216,1541.5337624925803
2025-06-13 18:30:00,2025-06-13 19:00:00,BUY,3424.23,3420.36,0.01,-38.7,stop_loss,3,"{'rsi_14': 53.278239841407064, 'adx': 11.498533705169242, 'trend_strength': 0.11498533705169242, 'volatility_ratio': 0.0014112598380760452, 'bb_width': 0.004162687401954372, 'prediction_confidence': 0.6, 'prediction_stability': 0.6, 'market_score': 5, 'raw_prediction': 1.5519322179180445e-07, 'scaled_prediction': 7.759661089590223e-05}",-77.4,217,1502.8337624925803
2025-06-13 19:15:00,2025-06-13 19:45:00,BUY,3426.95,3429.78,0.01,28.3,take_profit,3,"{'rsi_14': 53.278239841407064, 'adx': 11.498533705169242, 'trend_strength': 0.11498533705169242, 'volatility_ratio': 0.0014112598380760452, 'bb_width': 0.004162687401954372, 'prediction_confidence': 0.6, 'prediction_stability': 0.6, 'market_score': 5, 'raw_prediction': 8.673947003915944e-08, 'scaled_prediction': 4.336973501957972e-05}",56.6,218,1531.1337624925802
2025-06-13 20:00:00,2025-06-13 20:30:00,BUY,3431.38,3429.4,0.01,-19.8,stop_loss,3,"{'rsi_14': 53.278239841407064, 'adx': 11.498533705169242, 'trend_strength': 0.11498533705169242, 'volatility_ratio': 0.0014112598380760452, 'bb_width': 0.004162687401954372, 'prediction_confidence': 0.6, 'prediction_stability': 0.6, 'market_score': 5, 'raw_prediction': 9.887767386048024e-08, 'scaled_prediction': 4.943883693024012e-05}",-39.6,219,1511.3337624925803
2025-06-13 20:45:00,2025-06-13 21:00:00,BUY,3430.5,3433.02,0.01,25.2,take_profit,1,"{'rsi_14': 53.278239841407064, 'adx': 11.498533705169242, 'trend_strength': 0.11498533705169242, 'volatility_ratio': 0.0014112598380760452, 'bb_width': 0.004162687401954372, 'prediction_confidence': 0.6, 'prediction_stability': 0.6, 'market_score': 5, 'raw_prediction': 7.240491695296887e-08, 'scaled_prediction': 3.6202458476484435e-05}",50.4,220,1536.5337624925803
2025-06-13 21:30:00,2025-06-13 22:45:00,BUY,3435.14,3432.47,0.01,-26.7,stop_loss,9,"{'rsi_14': 53.278239841407064, 'adx': 11.498533705169242, 'trend_strength': 0.11498533705169242, 'volatility_ratio': 0.0014112598380760452, 'bb_width': 0.004162687401954372, 'prediction_confidence': 0.6, 'prediction_stability': 0.6, 'market_score': 5, 'raw_prediction': 5.959370175221075e-08, 'scaled_prediction': 2.9796850876105374e-05}",-53.4,221,1509.8337624925803
